"","Location","Music","Price","Sales","Income","Cost","Profit"
"1","Park","Alternative",28,64,1792,1248,544
"2","Business","Alternative",35,17,595,919,-324
"3","Business","Alternative",35,22,770,954,-184
"4","Park","HipHop",32,30,960,1010,-50
"5","Park","HipHop",35,27,945,989,-44
"6","Business","HipHop",32,27,864,989,-125
"7","Business","Alternative",32,30,960,1010,-50
"8","Park","Alternative",32,38,1216,1066,150
"9","Business","Alternative",32,29,928,1003,-75
"10","Park","HipHop",32,56,1792,1192,600
"11","Business","HipHop",35,29,1015,1003,12
"12","Park","Alternative",32,58,1856,1206,650
"13","Park","Alternative",35,24,840,968,-128
"14","Business","HipHop",35,32,1120,1024,96
"15","Park","HipHop",35,32,1120,1024,96
"16","Business","HipHop",32,35,1120,1045,75
"17","Park","Alternative",32,46,1472,1122,350
"18","Business","Alternative",35,21,735,947,-212
"19","Park","HipHop",32,37,1184,1059,125
"20","Business","Alternative",32,37,1184,1059,125
"21","Park","Alternative",35,32,1120,1024,96
"22","Park","Alternative",35,41,1435,1087,348
"23","Business","HipHop",32,34,1088,1038,50
"24","Business","HipHop",35,26,910,982,-72
"25","Park","HipHop",35,26,910,982,-72
"26","Business","Alternative",35,26,910,982,-72
"27","Business","Alternative",35,36,1260,1052,208
"28","Business","Alternative",35,22,770,954,-184
"29","Business","Alternative",35,25,875,975,-100
"30","Business","Alternative",35,16,560,912,-352
"31","Business","Alternative",35,5,175,835,-660
"32","Business","Alternative",28,46,1288,1122,166
"33","Business","Alternative",28,47,1316,1129,187
"34","Business","Alternative",28,50,1400,1150,250
"35","Zoo","Alternative",32,2,64,814,-750
"36","Zoo","Alternative",28,22,616,954,-338
"37","CityHall","Alternative",32,21,672,947,-275
"38","Park","Alternative",32,40,1280,1080,200
"39","Business","Alternative",28,49,1372,1143,229
"40","Business","Alternative",32,22,704,954,-250
"41","CityHall","Alternative",28,37,1036,1059,-23
"42","Park","Alternative",28,58,1624,1206,418
"43","CityHall","HipHop",32,42,1344,1094,250
"44","CityHall","HipHop",32,24,768,968,-200
"45","CityHall","HipHop",32,26,832,982,-150
"46","CityHall","HipHop",32,44,1408,1108,300
"47","CityHall","HipHop",32,28,896,996,-100
"48","CityHall","HipHop",32,30,960,1010,-50
"49","CityHall","HipHop",32,40,1280,1080,200
"50","CityHall","HipHop",32,36,1152,1052,100
"51","CityHall","HipHop",32,28,896,996,-100
"52","CityHall","HipHop",32,28,896,996,-100
"53","CityHall","HipHop",32,24,768,968,-200
"54","CityHall","HipHop",32,23,736,961,-225
"55","CityHall","HipHop",32,30,960,1010,-50
"56","CityHall","HipHop",32,18,576,926,-350
"57","CityHall","HipHop",32,40,1280,1080,200
"58","CityHall","HipHop",32,26,832,982,-150
"59","CityHall","HipHop",32,28,896,996,-100
"60","CityHall","HipHop",32,34,1088,1038,50
"61","CityHall","HipHop",32,30,960,1010,-50
"62","CityHall","HipHop",32,20,640,940,-300
"63","CityHall","HipHop",32,22,704,954,-250
"64","CityHall","HipHop",32,47,1504,1129,375
"65","CityHall","HipHop",32,25,800,975,-175
"66","CityHall","HipHop",32,16,512,912,-400
"67","CityHall","HipHop",32,35,1120,1045,75
"68","CityHall","HipHop",32,42,1344,1094,250
"69","CityHall","HipHop",32,28,896,996,-100
"70","CityHall","HipHop",32,20,640,940,-300
"71","CityHall","HipHop",32,37,1184,1059,125
"72","CityHall","HipHop",32,29,928,1003,-75
"73","CityHall","HipHop",32,29,928,1003,-75
"74","CityHall","HipHop",32,42,1344,1094,250
"75","CityHall","HipHop",32,34,1088,1038,50
"76","CityHall","HipHop",32,32,1024,1024,0
"77","CityHall","HipHop",32,27,864,989,-125
"78","CityHall","HipHop",32,31,992,1017,-25
"79","CityHall","HipHop",32,18,576,926,-350
"80","CityHall","HipHop",32,19,608,933,-325
"81","CityHall","HipHop",32,19,608,933,-325
"82","CityHall","HipHop",32,35,1120,1045,75
"83","CityHall","HipHop",32,24,768,968,-200
"84","CityHall","HipHop",32,17,544,919,-375
"85","CityHall","HipHop",32,42,1344,1094,250
"86","CityHall","HipHop",32,19,608,933,-325
"87","CityHall","HipHop",32,4,128,828,-700
"88","Business","HipHop",32,24,768,968,-200
"89","Park","Alternative",32,44,1408,1108,300
"90","Park","Alternative",28,59,1652,1213,439
"91","Park","Alternative",35,38,1330,1066,264
"92","Park","Alternative",35,50,1750,1150,600
"93","Park","Alternative",35,50,1750,1150,600
"94","Park","Alternative",35,34,1190,1038,152
"95","Park","Alternative",35,35,1225,1045,180
"96","Park","Alternative",35,54,1890,1178,712
"97","Park","Alternative",35,30,1050,1010,40
"98","Park","Alternative",35,46,1610,1122,488
"99","Park","Alternative",35,42,1470,1094,376
"100","Park","Alternative",35,44,1540,1108,432
"101","Park","Alternative",35,48,1680,1136,544
"102","Park","Alternative",35,42,1470,1094,376
"103","Park","Alternative",35,42,1470,1094,376
"104","Park","Alternative",35,42,1470,1094,376
"105","Park","Alternative",35,40,1400,1080,320
"106","Park","Alternative",35,35,1225,1045,180
"107","Park","Alternative",35,54,1890,1178,712
"108","Park","Alternative",35,42,1470,1094,376
"109","Park","Alternative",35,41,1435,1087,348
"110","Park","Alternative",35,38,1330,1066,264
"111","Park","Alternative",35,39,1365,1073,292
"112","Park","Alternative",35,53,1855,1171,684
"113","Park","Alternative",35,50,1750,1150,600
"114","Park","Alternative",35,44,1540,1108,432
"115","Park","Alternative",35,42,1470,1094,376
"116","Park","Alternative",35,46,1610,1122,488
"117","Park","Alternative",35,49,1715,1143,572
"118","Park","Alternative",35,38,1330,1066,264
"119","Park","Alternative",35,44,1540,1108,432
"120","Park","Alternative",35,47,1645,1129,516
"121","Park","Alternative",35,50,1750,1150,600
"122","Park","Alternative",35,38,1330,1066,264
"123","Park","Alternative",35,41,1435,1087,348
"124","Park","Alternative",35,42,1470,1094,376
"125","Park","Alternative",35,46,1610,1122,488
"126","Park","Alternative",35,39,1365,1073,292
"127","Park","Alternative",35,42,1470,1094,376
"128","Park","Alternative",35,38,1330,1066,264
"129","Park","Alternative",35,52,1820,1164,656
"130","Park","Alternative",35,40,1400,1080,320
"131","Park","Alternative",35,45,1575,1115,460
"132","Park","Alternative",35,36,1260,1052,208
"133","Park","Alternative",35,36,1260,1052,208
"134","Park","Alternative",35,38,1330,1066,264
"135","Park","Alternative",35,36,1260,1052,208
"136","Park","Alternative",35,43,1505,1101,404
"137","Park","Alternative",35,44,1540,1108,432
"138","Park","Alternative",35,40,1400,1080,320
"139","Park","Alternative",35,46,1610,1122,488
"140","Park","Alternative",35,42,1470,1094,376
"141","Park","Alternative",35,46,1610,1122,488
"142","Park","Alternative",35,51,1785,1157,628
"143","Park","Alternative",35,38,1330,1066,264
"144","Park","Alternative",35,41,1435,1087,348
"145","Park","Alternative",35,38,1330,1066,264
"146","Park","Alternative",35,38,1330,1066,264
"147","Park","Alternative",35,56,1960,1192,768
"148","Park","Alternative",35,39,1365,1073,292
"149","Park","Alternative",35,41,1435,1087,348
"150","Park","Alternative",35,42,1470,1094,376
"151","Park","Alternative",35,34,1190,1038,152
"152","Park","Alternative",35,40,1400,1080,320
"153","Park","Alternative",35,50,1750,1150,600
"154","Park","Alternative",35,42,1470,1094,376
"155","Park","Alternative",35,36,1260,1052,208
"156","Park","Alternative",35,48,1680,1136,544
"157","Park","Alternative",35,45,1575,1115,460
"158","Park","Alternative",35,46,1610,1122,488
"159","Park","Alternative",35,38,1330,1066,264
"160","Park","Alternative",35,43,1505,1101,404
"161","Park","Alternative",35,38,1330,1066,264
"162","Park","Alternative",35,49,1715,1143,572
"163","Park","Alternative",35,43,1505,1101,404
"164","Park","Alternative",35,35,1225,1045,180
"165","Park","Alternative",35,36,1260,1052,208
"166","Park","Alternative",35,42,1470,1094,376
"167","Park","Alternative",35,40,1400,1080,320
"168","Park","Alternative",35,43,1505,1101,404
"169","Park","Alternative",35,39,1365,1073,292
"170","Park","Alternative",35,42,1470,1094,376
"171","Park","Alternative",35,43,1505,1101,404
"172","Park","Alternative",35,40,1400,1080,320
"173","Park","Alternative",35,47,1645,1129,516
"174","Park","Alternative",35,44,1540,1108,432
"175","Park","Alternative",35,43,1505,1101,404
"176","Park","Alternative",35,41,1435,1087,348
"177","Park","Alternative",35,38,1330,1066,264
"178","Park","Alternative",35,48,1680,1136,544
"179","Park","Alternative",35,48,1680,1136,544
"180","Park","Alternative",35,44,1540,1108,432
"181","Park","Alternative",35,50,1750,1150,600
"182","Park","Alternative",35,44,1540,1108,432
"183","Park","Alternative",35,35,1225,1045,180
"184","Park","Alternative",35,41,1435,1087,348
"185","Park","Alternative",35,44,1540,1108,432
"186","Park","Alternative",35,48,1680,1136,544
"187","Park","Alternative",35,46,1610,1122,488
"188","Park","Alternative",35,38,1330,1066,264
"189","Park","Alternative",35,48,1680,1136,544
"190","Park","Alternative",35,42,1470,1094,376
"191","Park","Alternative",35,34,1190,1038,152
"192","Park","Alternative",35,50,1750,1150,600
"193","Park","Alternative",35,42,1470,1094,376
"194","Park","Alternative",35,41,1435,1087,348
"195","Park","Alternative",35,44,1540,1108,432
"196","Park","Alternative",35,46,1610,1122,488
"197","Park","Alternative",35,32,1120,1024,96
"198","Park","Alternative",35,43,1505,1101,404
"199","Park","Alternative",35,45,1575,1115,460
"200","Park","Alternative",35,42,1470,1094,376
"201","Park","Alternative",35,34,1190,1038,152
"202","Park","Alternative",35,44,1540,1108,432
"203","Park","Alternative",35,44,1540,1108,432
"204","Park","Alternative",35,56,1960,1192,768
"205","Park","Alternative",35,45,1575,1115,460
"206","Park","Alternative",35,42,1470,1094,376
"207","Park","Alternative",35,44,1540,1108,432
"208","Park","Alternative",35,36,1260,1052,208
"209","Park","Alternative",35,50,1750,1150,600
"210","Park","Alternative",35,38,1330,1066,264
"211","Park","Alternative",35,41,1435,1087,348
"212","Park","Alternative",40,28,1120,996,124
"213","Park","Alternative",40,42,1680,1094,586
"214","Park","Alternative",32,57,1824,1199,625
"215","Park","Alternative",35,42,1470,1094,376
"216","Park","Alternative",40,34,1360,1038,322
"217","Park","Alternative",32,49,1568,1143,425
"218","Park","Alternative",32,53,1696,1171,525
"219","Park","Alternative",35,44,1540,1108,432
"220","Park","Alternative",40,29,1160,1003,157
"221","Park","Alternative",32,54,1728,1178,550
"222","Park","Alternative",35,51,1785,1157,628
"223","Park","Alternative",35,37,1295,1059,236
"224","Park","Alternative",40,31,1240,1017,223
"225","Park","Alternative",32,44,1408,1108,300
"226","Park","Alternative",35,42,1470,1094,376
"227","Park","Alternative",40,32,1280,1024,256
"228","Park","Alternative",32,48,1536,1136,400
"229","Park","Alternative",35,38,1330,1066,264
"230","Park","Alternative",40,34,1360,1038,322
"231","Park","Alternative",32,54,1728,1178,550
"232","Park","Alternative",35,50,1750,1150,600
"233","Park","Alternative",40,39,1560,1073,487
"234","Park","Alternative",32,44,1408,1108,300
"235","Park","Alternative",35,44,1540,1108,432
"236","Park","Alternative",40,30,1200,1010,190
"237","Park","Alternative",40,18,720,926,-206
"238","Park","Alternative",32,54,1728,1178,550
"239","Park","Alternative",35,38,1330,1066,264
"240","Park","Alternative",40,36,1440,1052,388
"241","Park","Alternative",32,57,1824,1199,625
"242","Park","Alternative",32,64,2048,1248,800
"243","Park","Alternative",35,38,1330,1066,264
"244","Park","Alternative",40,38,1520,1066,454
"245","Park","Alternative",32,50,1600,1150,450
"246","Park","Alternative",35,38,1330,1066,264
"247","Park","Alternative",35,48,1680,1136,544
"248","Park","Alternative",40,37,1480,1059,421
"249","Park","Alternative",32,53,1696,1171,525
"250","Park","Alternative",35,43,1505,1101,404
"251","Park","Alternative",40,29,1160,1003,157
"252","Park","Alternative",40,34,1360,1038,322
"253","Park","Alternative",32,47,1504,1129,375
"254","Park","Alternative",35,46,1610,1122,488
"255","Park","Alternative",40,32,1280,1024,256
"256","Park","Alternative",32,46,1472,1122,350
"257","Park","Alternative",32,44,1408,1108,300
"258","Park","Alternative",35,38,1330,1066,264
"259","Park","Alternative",40,34,1360,1038,322
"260","Park","Alternative",32,36,1152,1052,100
"261","Park","Alternative",35,52,1820,1164,656
"262","Park","Alternative",35,42,1470,1094,376
"263","Park","Alternative",40,30,1200,1010,190
"264","Park","Alternative",32,56,1792,1192,600
"265","Park","Alternative",35,41,1435,1087,348
"266","Park","Alternative",40,32,1280,1024,256
"267","Park","Alternative",32,55,1760,1185,575
"268","Park","Alternative",35,45,1575,1115,460
"269","Park","Alternative",40,35,1400,1045,355
"270","Park","Alternative",32,47,1504,1129,375
"271","Park","Alternative",32,40,1280,1080,200
"272","Park","Alternative",32,53,1696,1171,525
"273","Park","Alternative",32,47,1504,1129,375
"274","Park","Alternative",35,46,1610,1122,488
"275","Park","Alternative",40,34,1360,1038,322
"276","Park","Alternative",35,30,1050,1010,40
"277","Park","Alternative",35,38,1330,1066,264
"278","Park","Alternative",35,47,1645,1129,516
"279","Park","Alternative",40,30,1200,1010,190
"280","Park","Alternative",40,28,1120,996,124
"281","Park","Alternative",35,48,1680,1136,544
"282","Park","Alternative",35,38,1330,1066,264
"283","Park","Alternative",40,34,1360,1038,322
"284","Park","Alternative",35,48,1680,1136,544
"285","Park","Alternative",40,28,1120,996,124
"286","Park","Alternative",35,44,1540,1108,432
"287","Park","Alternative",35,36,1260,1052,208
"288","Park","Alternative",35,35,1225,1045,180
"289","Park","Alternative",40,44,1760,1108,652
"290","Park","Alternative",32,46,1472,1122,350
"291","Park","Alternative",40,38,1520,1066,454
"292","Park","Alternative",32,51,1632,1157,475
"293","Park","Alternative",40,34,1360,1038,322
"294","Park","Alternative",32,40,1280,1080,200
"295","Park","Alternative",32,59,1888,1213,675
"296","Park","Alternative",40,44,1760,1108,652
"297","Park","Alternative",32,50,1600,1150,450
"298","Park","Alternative",35,40,1400,1080,320
"299","Park","Alternative",35,41,1435,1087,348
"300","Park","Alternative",35,41,1435,1087,348
"301","Park","Alternative",32,46,1472,1122,350
"302","Park","Alternative",35,35,1225,1045,180
"303","Park","Alternative",35,32,1120,1024,96
"304","Park","Alternative",40,34,1360,1038,322
"305","Park","Alternative",32,52,1664,1164,500
"306","Park","Alternative",32,55,1760,1185,575
"307","Park","Alternative",32,53,1696,1171,525
"308","Park","Alternative",35,46,1610,1122,488
"309","Park","Alternative",32,54,1728,1178,550
"310","Park","Alternative",40,30,1200,1010,190
"311","Park","Alternative",40,33,1320,1031,289
"312","Park","Alternative",40,34,1360,1038,322
"313","Park","Alternative",32,50,1600,1150,450
"314","Park","Alternative",32,51,1632,1157,475
"315","Park","Alternative",40,38,1520,1066,454
"316","Park","Alternative",40,46,1840,1122,718
"317","Park","Alternative",35,44,1540,1108,432
"318","Park","Alternative",35,40,1400,1080,320
"319","Park","Alternative",32,56,1792,1192,600
"320","Park","Alternative",32,51,1632,1157,475
"321","Park","Alternative",35,42,1470,1094,376
"322","Park","Alternative",40,32,1280,1024,256
"323","Park","Alternative",40,39,1560,1073,487
"324","Park","Alternative",32,56,1792,1192,600
"325","Park","Alternative",35,53,1855,1171,684
"326","Park","Alternative",32,50,1600,1150,450
"327","Park","Alternative",40,40,1600,1080,520
"328","Park","Alternative",40,32,1280,1024,256
"329","Park","Alternative",40,33,1320,1031,289
"330","Park","Alternative",32,62,1984,1234,750
"331","Park","Alternative",40,34,1360,1038,322
"332","Park","Alternative",32,53,1696,1171,525
"333","Park","Alternative",32,52,1664,1164,500
"334","Park","Alternative",35,48,1680,1136,544
"335","Park","Alternative",32,53,1696,1171,525
"336","Park","Alternative",40,34,1360,1038,322
"337","Park","Alternative",32,51,1632,1157,475
"338","Park","Alternative",40,34,1360,1038,322
"339","Park","Alternative",32,44,1408,1108,300
"340","Park","Alternative",32,56,1792,1192,600
"341","Park","Alternative",35,38,1330,1066,264
"342","Park","Alternative",40,40,1600,1080,520
"343","Park","Alternative",32,56,1792,1192,600
"344","Park","Alternative",40,32,1280,1024,256
"345","Park","Alternative",32,54,1728,1178,550
"346","Park","Alternative",35,51,1785,1157,628
"347","Park","Alternative",32,53,1696,1171,525
"348","Park","Alternative",32,48,1536,1136,400
"349","Park","Alternative",35,42,1470,1094,376
"350","Park","Alternative",35,46,1610,1122,488
"351","Park","Alternative",40,39,1560,1073,487
"352","Park","Alternative",35,60,2100,1220,880
"353","Park","Alternative",35,50,1750,1150,600
"354","Park","Alternative",40,42,1680,1094,586
"355","Park","Alternative",35,52,1820,1164,656
"356","Park","Alternative",40,26,1040,982,58
"357","Park","Alternative",35,50,1750,1150,600
"358","Park","Alternative",32,49,1568,1143,425
"359","Park","Alternative",40,30,1200,1010,190
"360","Park","Alternative",40,30,1200,1010,190
"361","Park","Alternative",40,33,1320,1031,289
"362","Park","Alternative",35,44,1540,1108,432
"363","Park","Alternative",32,52,1664,1164,500
"364","Park","Alternative",40,27,1080,989,91
"365","Park","Alternative",32,52,1664,1164,500
"366","Park","Alternative",40,29,1160,1003,157
"367","Park","Alternative",32,52,1664,1164,500
"368","Park","Alternative",40,28,1120,996,124
"369","Park","Alternative",32,62,1984,1234,750
"370","Park","Alternative",35,48,1680,1136,544
"371","Park","Alternative",35,40,1400,1080,320
"372","Park","Alternative",32,47,1504,1129,375
"373","Park","Alternative",40,34,1360,1038,322
"374","Park","Alternative",35,44,1540,1108,432
"375","Park","Alternative",32,51,1632,1157,475
"376","Park","Alternative",35,42,1470,1094,376
"377","Park","Alternative",40,34,1360,1038,322
"378","Park","Alternative",40,39,1560,1073,487
"379","Park","Alternative",35,46,1610,1122,488
"380","Park","Alternative",35,46,1610,1122,488
"381","Park","Alternative",40,32,1280,1024,256
"382","Park","Alternative",35,46,1610,1122,488
"383","Park","Alternative",35,36,1260,1052,208
"384","Park","Alternative",32,51,1632,1157,475
"385","Park","Alternative",40,35,1400,1045,355
"386","Park","Alternative",32,58,1856,1206,650
"387","Park","Alternative",32,53,1696,1171,525
"388","Park","Alternative",35,42,1470,1094,376
"389","Park","Alternative",40,36,1440,1052,388
"390","Park","Alternative",35,40,1400,1080,320
"391","Park","Alternative",35,49,1715,1143,572
"392","Park","Alternative",35,42,1470,1094,376
"393","Park","Alternative",40,33,1320,1031,289
"394","Park","Alternative",32,49,1568,1143,425
"395","Park","Alternative",40,28,1120,996,124
"396","Park","Alternative",40,24,960,968,-8
"397","Park","Alternative",32,47,1504,1129,375
"398","Park","Alternative",40,25,1000,975,25
"399","Park","Alternative",35,40,1400,1080,320
"400","Park","Alternative",32,56,1792,1192,600
"401","Park","Alternative",35,40,1400,1080,320
"402","Park","Alternative",32,52,1664,1164,500
"403","Park","Alternative",32,55,1760,1185,575
"404","Park","Alternative",35,46,1610,1122,488
"405","Park","Alternative",40,30,1200,1010,190
"406","Park","Alternative",40,31,1240,1017,223
"407","Park","Alternative",35,41,1435,1087,348
"408","Park","Alternative",40,29,1160,1003,157
"409","Park","Alternative",32,46,1472,1122,350
"410","Park","Alternative",32,56,1792,1192,600
"411","Park","Alternative",32,46,1472,1122,350
"412","Park","Alternative",32,54,1728,1178,550
"413","Park","Alternative",35,43,1505,1101,404
"414","Park","Alternative",32,54,1728,1178,550
"415","Park","Alternative",35,38,1330,1066,264
"416","Park","Alternative",35,56,1960,1192,768
"417","Park","Alternative",40,33,1320,1031,289
"418","Park","Alternative",35,47,1645,1129,516
"419","Park","Alternative",40,30,1200,1010,190
"420","Park","Alternative",40,24,960,968,-8
"421","Park","Alternative",35,44,1540,1108,432
"422","Park","Alternative",32,55,1760,1185,575
"423","Park","Alternative",32,65,2080,1255,825
"424","Park","Alternative",40,37,1480,1059,421
"425","Park","Alternative",40,34,1360,1038,322
"426","Park","Alternative",35,34,1190,1038,152
"427","Park","Alternative",32,47,1504,1129,375
"428","Park","Alternative",35,44,1540,1108,432
"429","Park","Alternative",40,32,1280,1024,256
"430","Park","Alternative",35,38,1330,1066,264
"431","Park","Alternative",35,42,1470,1094,376
"432","Park","Alternative",40,33,1320,1031,289
"433","Park","Alternative",32,55,1760,1185,575
"434","Park","Alternative",32,49,1568,1143,425
"435","Park","Alternative",35,37,1295,1059,236
"436","Park","Alternative",40,24,960,968,-8
"437","Park","Alternative",35,28,980,996,-16
"438","Park","Alternative",35,38,1330,1066,264
"439","Park","Alternative",32,44,1408,1108,300
"440","Park","Alternative",32,54,1728,1178,550
"441","Park","Alternative",32,56,1792,1192,600
"442","Park","Alternative",40,36,1440,1052,388
"443","Park","Alternative",32,54,1728,1178,550
"444","Park","Alternative",35,48,1680,1136,544
"445","Park","Alternative",40,33,1320,1031,289
"446","Park","Alternative",35,48,1680,1136,544
"447","Park","Alternative",32,52,1664,1164,500
"448","Park","Alternative",40,36,1440,1052,388
"449","Park","Alternative",40,30,1200,1010,190
"450","Park","Alternative",40,30,1200,1010,190
"451","Park","Alternative",40,41,1640,1087,553
"452","Park","Alternative",35,40,1400,1080,320
"453","Park","Alternative",35,44,1540,1108,432
"454","Park","Alternative",35,52,1820,1164,656
"455","Park","Alternative",35,32,1120,1024,96
"456","Park","Alternative",32,46,1472,1122,350
"457","Park","Alternative",32,50,1600,1150,450
"458","Park","Alternative",35,38,1330,1066,264
"459","Park","Alternative",40,29,1160,1003,157
"460","Park","Alternative",32,63,2016,1241,775
"461","Park","Alternative",32,46,1472,1122,350
"462","Park","Alternative",35,47,1645,1129,516
"463","Park","Alternative",40,42,1680,1094,586
"464","Park","Alternative",40,36,1440,1052,388
"465","Park","Alternative",32,53,1696,1171,525
"466","Park","Alternative",40,38,1520,1066,454
"467","Park","Alternative",40,30,1200,1010,190
"468","Park","Alternative",40,38,1520,1066,454
"469","Park","Alternative",32,47,1504,1129,375
"470","Park","Alternative",35,41,1435,1087,348
"471","Park","Alternative",40,43,1720,1101,619
"472","Park","Alternative",32,54,1728,1178,550
"473","Park","Alternative",40,34,1360,1038,322
"474","Park","Alternative",35,44,1540,1108,432
"475","Park","Alternative",35,44,1540,1108,432
"476","Park","Alternative",35,41,1435,1087,348
"477","Park","Alternative",35,44,1540,1108,432
"478","Park","Alternative",35,46,1610,1122,488
"479","Park","Alternative",32,60,1920,1220,700
"480","Park","Alternative",40,28,1120,996,124
"481","Park","Alternative",32,48,1536,1136,400
"482","Park","Alternative",32,57,1824,1199,625
"483","Park","Alternative",40,26,1040,982,58
"484","Park","Alternative",40,34,1360,1038,322
"485","Park","Alternative",32,50,1600,1150,450
"486","Park","Alternative",35,32,1120,1024,96
"487","Park","Alternative",40,28,1120,996,124
"488","Park","Alternative",32,53,1696,1171,525
"489","Park","Alternative",35,37,1295,1059,236
"490","Park","Alternative",32,54,1728,1178,550
"491","Park","Alternative",35,54,1890,1178,712
"492","Park","Alternative",32,56,1792,1192,600
"493","Park","Alternative",32,53,1696,1171,525
"494","Park","Alternative",32,59,1888,1213,675
"495","Park","Alternative",35,46,1610,1122,488
"496","Park","Alternative",35,52,1820,1164,656
"497","Park","Alternative",32,60,1920,1220,700
"498","Park","Alternative",32,40,1280,1080,200
"499","Park","Alternative",35,37,1295,1059,236
"500","Park","Alternative",40,30,1200,1010,190
"501","Park","Alternative",40,34,1360,1038,322
"502","Park","Alternative",40,32,1280,1024,256
"503","Park","Alternative",40,34,1360,1038,322
"504","Park","Alternative",40,44,1760,1108,652
"505","Park","Alternative",40,37,1480,1059,421
"506","Park","Alternative",32,56,1792,1192,600
"507","Park","Alternative",35,38,1330,1066,264
"508","Park","Alternative",32,46,1472,1122,350
"509","Park","Alternative",35,40,1400,1080,320
"510","Park","Alternative",40,31,1240,1017,223
"511","Park","Alternative",35,38,1330,1066,264
"512","Park","Alternative",40,34,1360,1038,322
"513","Park","Alternative",35,39,1365,1073,292
"514","Park","Alternative",32,56,1792,1192,600
"515","Park","Alternative",40,33,1320,1031,289
"516","Park","Alternative",35,42,1470,1094,376
"517","Park","Alternative",32,48,1536,1136,400
"518","Park","Alternative",32,60,1920,1220,700
"519","Park","Alternative",32,45,1440,1115,325
"520","Park","Alternative",35,35,1225,1045,180
"521","Park","Alternative",32,50,1600,1150,450
"522","Park","Alternative",40,28,1120,996,124
"523","Park","Alternative",35,47,1645,1129,516
"524","Park","Alternative",40,28,1120,996,124
"525","Park","Alternative",32,57,1824,1199,625
"526","Park","Alternative",35,34,1190,1038,152
"527","Park","Alternative",35,39,1365,1073,292
"528","Park","Alternative",32,52,1664,1164,500
"529","Park","Alternative",35,44,1540,1108,432
"530","Park","Alternative",35,39,1365,1073,292
"531","Park","Alternative",35,44,1540,1108,432
"532","Park","Alternative",40,38,1520,1066,454
"533","Park","Alternative",40,28,1120,996,124
"534","Park","Alternative",32,55,1760,1185,575
"535","Park","Alternative",40,26,1040,982,58
"536","Park","Alternative",40,36,1440,1052,388
"537","Park","Alternative",32,50,1600,1150,450
"538","Park","Alternative",32,45,1440,1115,325
"539","Park","Alternative",35,42,1470,1094,376
"540","Park","Alternative",40,22,880,954,-74
"541","Park","Alternative",32,56,1792,1192,600
"542","Park","Alternative",35,45,1575,1115,460
"543","Park","Alternative",40,38,1520,1066,454
"544","Park","Alternative",32,58,1856,1206,650
"545","Park","Alternative",35,42,1470,1094,376
"546","Park","Alternative",32,56,1792,1192,600
"547","Park","Alternative",35,43,1505,1101,404
"548","Park","Alternative",40,32,1280,1024,256
"549","Park","Alternative",35,46,1610,1122,488
"550","Park","Alternative",40,46,1840,1122,718
"551","Park","Alternative",32,48,1536,1136,400
"552","Park","Alternative",35,37,1295,1059,236
"553","Park","Alternative",35,42,1470,1094,376
"554","Park","Alternative",35,50,1750,1150,600
"555","Park","Alternative",40,31,1240,1017,223
"556","Park","Alternative",40,40,1600,1080,520
"557","Park","Alternative",40,38,1520,1066,454
"558","Park","Alternative",32,57,1824,1199,625
"559","Park","Alternative",35,43,1505,1101,404
"560","Park","Alternative",40,34,1360,1038,322
"561","Park","Alternative",40,35,1400,1045,355
"562","Park","Alternative",32,60,1920,1220,700
"563","Park","Alternative",32,46,1472,1122,350
"564","Park","Alternative",40,32,1280,1024,256
"565","Park","Alternative",40,30,1200,1010,190
"566","Park","Alternative",32,49,1568,1143,425
"567","Park","Alternative",32,62,1984,1234,750
"568","Park","Alternative",40,28,1120,996,124
"569","Park","Alternative",32,46,1472,1122,350
"570","Park","Alternative",35,34,1190,1038,152
"571","Park","Alternative",32,58,1856,1206,650
"572","Park","Alternative",35,42,1470,1094,376
"573","Park","Alternative",35,48,1680,1136,544
"574","Park","Alternative",32,46,1472,1122,350
"575","Park","Alternative",32,52,1664,1164,500
"576","Park","Alternative",40,34,1360,1038,322
"577","Park","Alternative",40,35,1400,1045,355
"578","Park","Alternative",35,45,1575,1115,460
"579","Park","Alternative",40,30,1200,1010,190
"580","Park","Alternative",32,54,1728,1178,550
"581","Park","Alternative",35,51,1785,1157,628
"582","Park","Alternative",32,52,1664,1164,500
"583","Park","Alternative",40,38,1520,1066,454
"584","Park","Alternative",35,38,1330,1066,264
"585","Park","Alternative",35,48,1680,1136,544
"586","Park","Alternative",35,46,1610,1122,488
"587","Park","Alternative",35,42,1470,1094,376
"588","Park","Alternative",35,44,1540,1108,432
"589","Park","Alternative",40,37,1480,1059,421
"590","Park","Alternative",40,41,1640,1087,553
"591","Park","Alternative",32,44,1408,1108,300
"592","Park","Alternative",35,53,1855,1171,684
"593","Park","Alternative",35,42,1470,1094,376
"594","Park","Alternative",32,55,1760,1185,575
"595","Park","Alternative",40,32,1280,1024,256
"596","Park","Alternative",40,38,1520,1066,454
"597","Park","Alternative",32,46,1472,1122,350
"598","Park","Alternative",32,52,1664,1164,500
"599","Park","Alternative",35,42,1470,1094,376
"600","Park","Alternative",40,29,1160,1003,157
"601","Park","Alternative",40,36,1440,1052,388
"602","Park","Alternative",32,51,1632,1157,475
"603","Park","Alternative",35,50,1750,1150,600
"604","Park","Alternative",40,44,1760,1108,652
"605","Park","Alternative",32,46,1472,1122,350
"606","Park","Alternative",40,33,1320,1031,289
"607","Park","Alternative",40,42,1680,1094,586
"608","Park","Alternative",40,29,1160,1003,157
"609","Park","Alternative",40,26,1040,982,58
"610","Park","Alternative",35,47,1645,1129,516
"611","Park","Alternative",32,55,1760,1185,575
"612","Park","Alternative",32,54,1728,1178,550
"613","Park","Alternative",32,48,1536,1136,400
"614","Park","Alternative",40,32,1280,1024,256
"615","Park","Alternative",35,37,1295,1059,236
"616","Park","Alternative",32,54,1728,1178,550
"617","Park","Alternative",40,35,1400,1045,355
"618","Park","Alternative",35,49,1715,1143,572
"619","Park","Alternative",32,55,1760,1185,575
"620","Park","Alternative",32,50,1600,1150,450
"621","Park","Alternative",32,50,1600,1150,450
"622","Park","Alternative",40,23,920,961,-41
"623","Park","Alternative",40,32,1280,1024,256
"624","Park","Alternative",35,40,1400,1080,320
"625","Park","Alternative",35,46,1610,1122,488
"626","Park","Alternative",35,43,1505,1101,404
"627","Park","Alternative",35,46,1610,1122,488
"628","Park","Alternative",40,31,1240,1017,223
"629","Park","Alternative",32,54,1728,1178,550
"630","Park","Alternative",32,49,1568,1143,425
"631","Park","Alternative",32,50,1600,1150,450
"632","Park","Alternative",32,50,1600,1150,450
"633","Park","Alternative",35,40,1400,1080,320
"634","Park","Alternative",35,43,1505,1101,404
"635","Park","Alternative",32,55,1760,1185,575
"636","Park","Alternative",35,46,1610,1122,488
"637","Park","Alternative",40,28,1120,996,124
"638","Park","Alternative",40,28,1120,996,124
"639","Park","Alternative",40,32,1280,1024,256
"640","Park","Alternative",35,44,1540,1108,432
"641","Park","Alternative",32,56,1792,1192,600
"642","Park","Alternative",32,51,1632,1157,475
"643","Park","Alternative",35,40,1400,1080,320
"644","Park","Alternative",40,37,1480,1059,421
"645","Park","Alternative",40,33,1320,1031,289
"646","Park","Alternative",32,60,1920,1220,700
"647","Park","Alternative",32,60,1920,1220,700
"648","Park","Alternative",40,37,1480,1059,421
"649","Park","Alternative",35,48,1680,1136,544
"650","Park","Alternative",32,57,1824,1199,625
"651","Park","Alternative",40,37,1480,1059,421
"652","Park","Alternative",35,38,1330,1066,264
"653","Park","Alternative",35,38,1330,1066,264
"654","Park","Alternative",32,52,1664,1164,500
"655","Park","Alternative",35,31,1085,1017,68
"656","Park","Alternative",35,44,1540,1108,432
"657","Park","Alternative",40,34,1360,1038,322
"658","Park","Alternative",40,32,1280,1024,256
"659","Park","Alternative",32,46,1472,1122,350
"660","Park","Alternative",40,38,1520,1066,454
"661","Park","Alternative",32,56,1792,1192,600
"662","Park","Alternative",35,40,1400,1080,320
"663","Park","Alternative",40,30,1200,1010,190
"664","Park","Alternative",40,29,1160,1003,157
"665","Park","Alternative",40,28,1120,996,124
"666","Park","Alternative",35,47,1645,1129,516
"667","Park","Alternative",32,56,1792,1192,600
"668","Park","Alternative",40,34,1360,1038,322
"669","Park","Alternative",40,26,1040,982,58
"670","Park","Alternative",32,59,1888,1213,675
"671","Park","Alternative",35,42,1470,1094,376
"672","Park","Alternative",32,53,1696,1171,525
"673","Park","Alternative",32,54,1728,1178,550
"674","Park","Alternative",40,28,1120,996,124
"675","Park","Alternative",35,51,1785,1157,628
"676","Park","Alternative",35,43,1505,1101,404
"677","Park","Alternative",40,34,1360,1038,322
"678","Park","Alternative",40,31,1240,1017,223
"679","Park","Alternative",35,48,1680,1136,544
"680","Park","Alternative",35,34,1190,1038,152
"681","Park","Alternative",32,55,1760,1185,575
"682","Park","Alternative",32,54,1728,1178,550
"683","Park","Alternative",40,38,1520,1066,454
"684","Park","Alternative",32,59,1888,1213,675
"685","Park","Alternative",35,42,1470,1094,376
"686","Park","Alternative",35,48,1680,1136,544
"687","Park","Alternative",32,60,1920,1220,700
"688","Park","Alternative",40,22,880,954,-74
"689","Park","Alternative",35,38,1330,1066,264
"690","Park","Alternative",32,58,1856,1206,650
"691","Park","Alternative",40,32,1280,1024,256
"692","Park","Alternative",35,47,1645,1129,516
"693","Park","Alternative",32,55,1760,1185,575
"694","Park","Alternative",32,66,2112,1262,850
"695","Park","Alternative",40,39,1560,1073,487
"696","Park","Alternative",40,36,1440,1052,388
"697","Park","Alternative",35,52,1820,1164,656
"698","Park","Alternative",35,42,1470,1094,376
"699","Park","Alternative",35,45,1575,1115,460
"700","Park","Alternative",32,64,2048,1248,800
"701","Park","Alternative",40,28,1120,996,124
"702","Park","Alternative",35,43,1505,1101,404
"703","Park","Alternative",35,44,1540,1108,432
"704","Park","Alternative",40,34,1360,1038,322
"705","Park","Alternative",32,58,1856,1206,650
"706","Park","Alternative",35,41,1435,1087,348
"707","Park","Alternative",32,62,1984,1234,750
"708","Park","Alternative",32,66,2112,1262,850
"709","Park","Alternative",40,40,1600,1080,520
"710","Park","Alternative",40,30,1200,1010,190
"711","Park","Alternative",35,47,1645,1129,516
"712","Park","Alternative",32,58,1856,1206,650
"713","Park","Alternative",40,34,1360,1038,322
"714","Park","Alternative",35,48,1680,1136,544
"715","Park","Alternative",32,58,1856,1206,650
"716","Park","Alternative",35,50,1750,1150,600
"717","Park","Alternative",40,30,1200,1010,190
"718","Park","Alternative",32,62,1984,1234,750
"719","Park","Alternative",40,41,1640,1087,553
"720","Park","Alternative",32,66,2112,1262,850
"721","Park","Alternative",32,58,1856,1206,650
"722","Park","Alternative",40,36,1440,1052,388
"723","Park","Alternative",35,54,1890,1178,712
"724","Park","Alternative",35,43,1505,1101,404
"725","Park","Alternative",32,48,1536,1136,400
"726","Park","Alternative",35,46,1610,1122,488
"727","Park","Alternative",32,62,1984,1234,750
"728","Park","Alternative",35,50,1750,1150,600
"729","Park","Alternative",40,32,1280,1024,256
"730","Park","Alternative",40,32,1280,1024,256
"731","Park","Alternative",35,38,1330,1066,264
"732","Park","Alternative",35,45,1575,1115,460
"733","Park","Alternative",35,45,1575,1115,460
"734","Park","Alternative",40,28,1120,996,124
"735","Park","Alternative",32,59,1888,1213,675
"736","Park","Alternative",40,29,1160,1003,157
"737","Park","Alternative",35,42,1470,1094,376
"738","Park","Alternative",40,32,1280,1024,256
"739","Park","Alternative",32,65,2080,1255,825
"740","Park","Alternative",35,30,1050,1010,40
"741","Park","Alternative",40,34,1360,1038,322
"742","Park","Alternative",32,51,1632,1157,475
"743","Park","Alternative",40,40,1600,1080,520
"744","Park","Alternative",32,60,1920,1220,700
"745","Park","Alternative",40,31,1240,1017,223
"746","Park","Alternative",32,60,1920,1220,700
"747","Park","Alternative",32,54,1728,1178,550
"748","Park","Alternative",35,40,1400,1080,320
"749","Park","Alternative",40,36,1440,1052,388
"750","Park","Alternative",35,38,1330,1066,264
"751","Park","Alternative",40,38,1520,1066,454
"752","Park","Alternative",32,58,1856,1206,650
"753","Park","Alternative",40,38,1520,1066,454
"754","Park","Alternative",40,30,1200,1010,190
"755","Park","Alternative",40,30,1200,1010,190
"756","Park","Alternative",32,54,1728,1178,550
"757","Park","Alternative",40,46,1840,1122,718
"758","Park","Alternative",32,58,1856,1206,650
"759","Park","Alternative",32,54,1728,1178,550
"760","Park","Alternative",35,32,1120,1024,96
"761","Park","Alternative",32,53,1696,1171,525
"762","Park","Alternative",40,36,1440,1052,388
"763","Park","Alternative",35,46,1610,1122,488
"764","Park","Alternative",40,36,1440,1052,388
"765","Park","Alternative",35,36,1260,1052,208
"766","Park","Alternative",40,26,1040,982,58
"767","Park","Alternative",32,58,1856,1206,650
"768","Park","Alternative",35,45,1575,1115,460
"769","Park","Alternative",32,66,2112,1262,850
"770","Park","Alternative",32,47,1504,1129,375
"771","Park","Alternative",40,26,1040,982,58
"772","Park","Alternative",35,46,1610,1122,488
"773","Park","Alternative",35,46,1610,1122,488
"774","Park","Alternative",32,54,1728,1178,550
"775","Park","Alternative",35,44,1540,1108,432
"776","Park","Alternative",35,43,1505,1101,404
"777","Park","Alternative",35,42,1470,1094,376
"778","Park","Alternative",32,68,2176,1276,900
"779","Park","Alternative",32,59,1888,1213,675
"780","Park","Alternative",40,32,1280,1024,256
"781","Park","Alternative",32,55,1760,1185,575
"782","Park","Alternative",32,56,1792,1192,600
"783","Park","Alternative",32,59,1888,1213,675
"784","Park","Alternative",32,48,1536,1136,400
"785","Park","Alternative",32,42,1344,1094,250
"786","Park","Alternative",32,58,1856,1206,650
"787","Park","Alternative",32,60,1920,1220,700
"788","Park","Alternative",32,66,2112,1262,850
"789","Park","Alternative",32,52,1664,1164,500
"790","Park","Alternative",32,67,2144,1269,875
"791","Park","Alternative",32,59,1888,1213,675
"792","Park","Alternative",32,59,1888,1213,675
"793","Park","Alternative",32,52,1664,1164,500
"794","Park","Alternative",32,58,1856,1206,650
"795","Park","Alternative",32,62,1984,1234,750
"796","Park","Alternative",32,51,1632,1157,475
"797","Park","Alternative",32,52,1664,1164,500
"798","Park","Alternative",32,54,1728,1178,550
"799","Park","Alternative",32,60,1920,1220,700
"800","Park","Alternative",32,65,2080,1255,825
"801","Park","Alternative",32,67,2144,1269,875
"802","Park","Alternative",32,61,1952,1227,725
"803","Park","Alternative",32,62,1984,1234,750
"804","Park","Alternative",32,62,1984,1234,750
"805","Park","Alternative",32,54,1728,1178,550
"806","Park","Alternative",32,52,1664,1164,500
"807","Park","Alternative",32,51,1632,1157,475
"808","Park","Alternative",32,62,1984,1234,750
"809","Park","Alternative",32,52,1664,1164,500
"810","Park","Alternative",32,58,1856,1206,650
"811","Park","Alternative",32,64,2048,1248,800
"812","Park","Alternative",32,52,1664,1164,500
"813","Park","Alternative",32,57,1824,1199,625
"814","Park","Alternative",32,60,1920,1220,700
"815","Park","Alternative",32,56,1792,1192,600
"816","Park","Alternative",32,72,2304,1304,1000
"817","Park","Alternative",32,60,1920,1220,700
"818","Park","Alternative",32,61,1952,1227,725
"819","Park","Alternative",32,60,1920,1220,700
"820","Park","Alternative",32,54,1728,1178,550
"821","Park","Alternative",32,60,1920,1220,700
"822","Park","Alternative",32,64,2048,1248,800
"823","Park","Alternative",32,64,2048,1248,800
"824","Park","Alternative",32,60,1920,1220,700
"825","Park","Alternative",32,55,1760,1185,575
"826","Park","Alternative",32,60,1920,1220,700
"827","Park","Alternative",32,56,1792,1192,600
"828","Park","Alternative",32,63,2016,1241,775
"829","Park","Alternative",32,60,1920,1220,700
"830","Park","Alternative",32,66,2112,1262,850
"831","Park","Alternative",32,67,2144,1269,875
"832","Park","Alternative",32,56,1792,1192,600
"833","Park","Alternative",32,62,1984,1234,750
"834","Park","Alternative",32,57,1824,1199,625
"835","Park","Alternative",32,56,1792,1192,600
"836","Park","Alternative",32,67,2144,1269,875
"837","Park","Alternative",32,64,2048,1248,800
"838","Park","Alternative",32,60,1920,1220,700
"839","Park","Alternative",32,60,1920,1220,700
"840","Park","Alternative",32,56,1792,1192,600
"841","Park","Alternative",35,46,1610,1122,488
"842","Park","Alternative",35,44,1540,1108,432
"843","Park","Alternative",35,48,1680,1136,544
"844","Park","Alternative",35,50,1750,1150,600
"845","Park","Alternative",35,50,1750,1150,600
"846","Park","Alternative",35,45,1575,1115,460
"847","Park","Alternative",35,44,1540,1108,432
"848","Park","Alternative",35,39,1365,1073,292
"849","Park","Alternative",35,54,1890,1178,712
"850","Park","Alternative",35,50,1750,1150,600
"851","Park","Alternative",35,44,1540,1108,432
"852","Park","Alternative",35,42,1470,1094,376
"853","Park","Alternative",35,45,1575,1115,460
"854","Park","Alternative",35,48,1680,1136,544
"855","Park","Alternative",35,40,1400,1080,320
"856","Park","Alternative",35,38,1330,1066,264
"857","Park","Alternative",35,38,1330,1066,264
"858","Park","Alternative",35,42,1470,1094,376
"859","Park","Alternative",35,44,1540,1108,432
"860","Park","Alternative",35,36,1260,1052,208
"861","Park","Alternative",35,42,1470,1094,376
"862","Park","Alternative",35,40,1400,1080,320
"863","Park","Alternative",35,43,1505,1101,404
"864","Park","Alternative",35,32,1120,1024,96
"865","Park","Alternative",35,37,1295,1059,236
"866","Park","Alternative",35,38,1330,1066,264
"867","Park","Alternative",35,42,1470,1094,376
"868","Park","Alternative",35,42,1470,1094,376
"869","Park","Alternative",35,52,1820,1164,656
"870","Park","Alternative",35,36,1260,1052,208
"871","Park","Alternative",35,46,1610,1122,488
"872","Park","Alternative",35,50,1750,1150,600
"873","Park","Alternative",35,40,1400,1080,320
"874","Park","Alternative",35,40,1400,1080,320
"875","Park","Alternative",35,32,1120,1024,96
"876","Park","Alternative",35,40,1400,1080,320
"877","Park","Alternative",35,31,1085,1017,68
"878","Park","Alternative",35,43,1505,1101,404
"879","Park","Alternative",35,37,1295,1059,236
"880","Park","Alternative",35,43,1505,1101,404
"881","Park","Alternative",35,40,1400,1080,320
"882","Park","Alternative",35,49,1715,1143,572
"883","Park","Alternative",35,37,1295,1059,236
"884","Park","Alternative",35,40,1400,1080,320
"885","Park","Alternative",35,40,1400,1080,320
"886","Park","Alternative",35,36,1260,1052,208
"887","Park","Alternative",35,52,1820,1164,656
"888","Park","Alternative",35,40,1400,1080,320
"889","Park","Alternative",35,48,1680,1136,544
"890","Park","Alternative",35,49,1715,1143,572
"891","Park","Alternative",35,38,1330,1066,264
"892","Park","Alternative",35,52,1820,1164,656
"893","Park","Alternative",35,39,1365,1073,292
"894","Park","Alternative",35,46,1610,1122,488
"895","Park","Alternative",35,32,1120,1024,96
"896","Park","Alternative",35,36,1260,1052,208
"897","Park","Alternative",35,34,1190,1038,152
"898","Park","Alternative",35,37,1295,1059,236
"899","Park","Alternative",35,40,1400,1080,320
"900","Park","Alternative",35,44,1540,1108,432
"901","Park","Alternative",40,29,1160,1003,157
"902","Park","Alternative",40,30,1200,1010,190
"903","Park","Alternative",40,28,1120,996,124
"904","Park","Alternative",40,30,1200,1010,190
"905","Park","Alternative",40,32,1280,1024,256
"906","Park","Alternative",40,38,1520,1066,454
"907","Park","Alternative",40,28,1120,996,124
"908","Park","Alternative",40,30,1200,1010,190
"909","Park","Alternative",40,36,1440,1052,388
"910","Park","Alternative",40,33,1320,1031,289
"911","Park","Alternative",40,27,1080,989,91
"912","Park","Alternative",40,28,1120,996,124
"913","Park","Alternative",40,24,960,968,-8
"914","Park","Alternative",40,34,1360,1038,322
"915","Park","Alternative",40,30,1200,1010,190
"916","Park","Alternative",40,30,1200,1010,190
"917","Park","Alternative",40,32,1280,1024,256
"918","Park","Alternative",40,32,1280,1024,256
"919","Park","Alternative",40,34,1360,1038,322
"920","Park","Alternative",40,30,1200,1010,190
"921","Park","Alternative",40,29,1160,1003,157
"922","Park","Alternative",40,34,1360,1038,322
"923","Park","Alternative",40,35,1400,1045,355
"924","Park","Alternative",40,26,1040,982,58
"925","Park","Alternative",40,43,1720,1101,619
"926","Park","Alternative",40,35,1400,1045,355
"927","Park","Alternative",40,35,1400,1045,355
"928","Park","Alternative",40,36,1440,1052,388
"929","Park","Alternative",40,32,1280,1024,256
"930","Park","Alternative",40,26,1040,982,58
"931","Park","Alternative",40,34,1360,1038,322
"932","Park","Alternative",40,42,1680,1094,586
"933","Park","Alternative",40,36,1440,1052,388
"934","Park","Alternative",40,34,1360,1038,322
"935","Park","Alternative",40,36,1440,1052,388
"936","Park","Alternative",40,35,1400,1045,355
"937","Park","Alternative",40,36,1440,1052,388
"938","Park","Alternative",40,38,1520,1066,454
"939","Park","Alternative",40,26,1040,982,58
"940","Park","Alternative",40,34,1360,1038,322
"941","Park","Alternative",40,30,1200,1010,190
"942","Park","Alternative",40,36,1440,1052,388
"943","Park","Alternative",40,26,1040,982,58
"944","Park","Alternative",40,28,1120,996,124
"945","Park","Alternative",40,32,1280,1024,256
"946","Park","Alternative",40,27,1080,989,91
"947","Park","Alternative",40,32,1280,1024,256
"948","Park","Alternative",40,35,1400,1045,355
"949","Park","Alternative",40,33,1320,1031,289
"950","Park","Alternative",40,34,1360,1038,322
"951","Park","Alternative",40,33,1320,1031,289
"952","Park","Alternative",40,31,1240,1017,223
"953","Park","Alternative",40,29,1160,1003,157
"954","Park","Alternative",40,26,1040,982,58
"955","Park","Alternative",40,38,1520,1066,454
"956","Park","Alternative",40,34,1360,1038,322
"957","Park","Alternative",40,24,960,968,-8
"958","Park","Alternative",40,26,1040,982,58
"959","Park","Alternative",40,32,1280,1024,256
"960","Park","Alternative",40,32,1280,1024,256
"961","Park","Alternative",40,31,1240,1017,223
"962","Park","Alternative",40,44,1760,1108,652
"963","Park","Alternative",40,39,1560,1073,487
"964","Park","Alternative",32,62,1984,1234,750
"965","Park","Alternative",35,44,1540,1108,432
"966","Park","Alternative",40,33,1320,1031,289
"967","Park","Alternative",32,66,2112,1262,850
"968","Park","Alternative",35,38,1330,1066,264
"969","Park","Alternative",40,34,1360,1038,322
"970","Park","Alternative",40,43,1720,1101,619
"971","Park","Alternative",40,33,1320,1031,289
"972","Park","Alternative",40,32,1280,1024,256
"973","Park","Alternative",32,63,2016,1241,775
"974","Park","Alternative",32,54,1728,1178,550
"975","Park","Alternative",35,42,1470,1094,376
"976","Park","Alternative",35,43,1505,1101,404
"977","Park","Alternative",32,56,1792,1192,600
"978","Park","Alternative",32,51,1632,1157,475
"979","Park","Alternative",35,36,1260,1052,208
"980","Park","Alternative",32,62,1984,1234,750
"981","Park","Alternative",35,44,1540,1108,432
"982","Park","Alternative",32,60,1920,1220,700
"983","Park","Alternative",35,43,1505,1101,404
"984","Park","Alternative",40,45,1800,1115,685
"985","Park","Alternative",35,43,1505,1101,404
"986","Park","Alternative",35,40,1400,1080,320
"987","Park","Alternative",40,33,1320,1031,289
"988","Park","Alternative",40,26,1040,982,58
"989","Park","Alternative",32,66,2112,1262,850
"990","Park","Alternative",40,32,1280,1024,256
"991","Park","Alternative",40,26,1040,982,58
"992","Park","Alternative",40,34,1360,1038,322
"993","Park","Alternative",35,48,1680,1136,544
"994","Park","Alternative",35,49,1715,1143,572
"995","Park","Alternative",32,60,1920,1220,700
"996","Park","Alternative",32,49,1568,1143,425
"997","Park","Alternative",32,48,1536,1136,400
"998","Park","Alternative",32,59,1888,1213,675
"999","Park","Alternative",35,46,1610,1122,488
"1000","Park","Alternative",35,42,1470,1094,376
"1001","Park","Alternative",35,40,1400,1080,320
"1002","Park","Alternative",35,50,1750,1150,600
"1003","Park","Alternative",35,49,1715,1143,572
"1004","Park","Alternative",35,48,1680,1136,544
"1005","Park","Alternative",32,55,1760,1185,575
"1006","Park","Alternative",35,36,1260,1052,208
"1007","Park","Alternative",32,60,1920,1220,700
"1008","Park","Alternative",40,35,1400,1045,355
"1009","Park","Alternative",32,63,2016,1241,775
"1010","Park","Alternative",32,64,2048,1248,800
"1011","Park","Alternative",40,31,1240,1017,223
"1012","Park","Alternative",32,65,2080,1255,825
"1013","Park","Alternative",32,54,1728,1178,550
"1014","Park","Alternative",40,32,1280,1024,256
"1015","Park","Alternative",32,51,1632,1157,475
"1016","Park","Alternative",40,30,1200,1010,190
"1017","Park","Alternative",35,42,1470,1094,376
"1018","Park","Alternative",40,36,1440,1052,388
"1019","Park","Alternative",35,57,1995,1199,796
"1020","Park","Alternative",40,32,1280,1024,256
"1021","Park","Alternative",35,46,1610,1122,488
"1022","Park","Alternative",32,58,1856,1206,650
"1023","Park","Alternative",32,54,1728,1178,550
"1024","Park","Alternative",40,40,1600,1080,520
"1025","Park","Alternative",40,39,1560,1073,487
"1026","Park","Alternative",32,71,2272,1297,975
"1027","Park","Alternative",32,63,2016,1241,775
"1028","Park","Alternative",32,66,2112,1262,850
"1029","Park","Alternative",40,25,1000,975,25
"1030","Park","Alternative",32,58,1856,1206,650
"1031","Park","Alternative",35,42,1470,1094,376
"1032","Park","Alternative",32,62,1984,1234,750
"1033","Park","Alternative",40,34,1360,1038,322
"1034","Park","Alternative",32,55,1760,1185,575
"1035","Park","Alternative",32,64,2048,1248,800
"1036","Park","Alternative",35,38,1330,1066,264
"1037","Park","Alternative",40,39,1560,1073,487
"1038","Park","Alternative",35,46,1610,1122,488
"1039","Park","Alternative",32,58,1856,1206,650
"1040","Park","Alternative",35,40,1400,1080,320
"1041","Park","Alternative",35,50,1750,1150,600
"1042","Park","Alternative",32,56,1792,1192,600
"1043","Park","Alternative",35,44,1540,1108,432
"1044","Park","Alternative",40,34,1360,1038,322
"1045","Park","Alternative",40,26,1040,982,58
"1046","Park","Alternative",32,64,2048,1248,800
"1047","Park","Alternative",40,30,1200,1010,190
"1048","Park","Alternative",35,45,1575,1115,460
"1049","Park","Alternative",40,38,1520,1066,454
"1050","Park","Alternative",35,46,1610,1122,488
"1051","Park","Alternative",35,42,1470,1094,376
"1052","Park","Alternative",40,33,1320,1031,289
"1053","Park","Alternative",35,42,1470,1094,376
"1054","Park","Alternative",35,50,1750,1150,600
"1055","Park","Alternative",35,46,1610,1122,488
"1056","Park","Alternative",32,58,1856,1206,650
"1057","Park","Alternative",40,21,840,947,-107
"1058","Park","Alternative",32,60,1920,1220,700
"1059","Park","Alternative",35,41,1435,1087,348
"1060","Park","Alternative",32,66,2112,1262,850
"1061","Park","Alternative",40,42,1680,1094,586
"1062","Park","Alternative",40,30,1200,1010,190
"1063","Park","Alternative",40,34,1360,1038,322
"1064","Park","Alternative",35,45,1575,1115,460
"1065","Park","Alternative",35,48,1680,1136,544
"1066","Park","Alternative",40,34,1360,1038,322
"1067","Park","Alternative",40,34,1360,1038,322
"1068","Park","Alternative",40,40,1600,1080,520
"1069","Park","Alternative",32,58,1856,1206,650
"1070","Park","Alternative",35,47,1645,1129,516
"1071","Park","Alternative",40,29,1160,1003,157
"1072","Park","Alternative",32,64,2048,1248,800
"1073","Park","Alternative",32,61,1952,1227,725
"1074","Park","Alternative",35,36,1260,1052,208
"1075","Park","Alternative",40,26,1040,982,58
"1076","Park","Alternative",32,53,1696,1171,525
"1077","Park","Alternative",35,42,1470,1094,376
"1078","Park","Alternative",32,58,1856,1206,650
"1079","Park","Alternative",40,34,1360,1038,322
"1080","Park","Alternative",35,40,1400,1080,320
"1081","Park","Alternative",35,41,1435,1087,348
"1082","Park","Alternative",40,36,1440,1052,388
"1083","Park","Alternative",32,54,1728,1178,550
"1084","Park","Alternative",35,36,1260,1052,208
"1085","Park","Alternative",40,26,1040,982,58
"1086","Park","Alternative",32,62,1984,1234,750
"1087","Park","Alternative",32,64,2048,1248,800
"1088","Park","Alternative",35,38,1330,1066,264
"1089","Park","Alternative",40,30,1200,1010,190
"1090","Park","Alternative",35,43,1505,1101,404
"1091","Park","Alternative",32,56,1792,1192,600
"1092","Park","Alternative",35,30,1050,1010,40
"1093","Park","Alternative",32,58,1856,1206,650
"1094","Park","Alternative",40,33,1320,1031,289
"1095","Park","Alternative",32,54,1728,1178,550
"1096","Park","Alternative",32,56,1792,1192,600
"1097","Park","Alternative",35,48,1680,1136,544
"1098","Park","Alternative",40,38,1520,1066,454
"1099","Park","Alternative",35,50,1750,1150,600
"1100","Park","Alternative",32,59,1888,1213,675
"1101","Park","Alternative",40,34,1360,1038,322
"1102","Park","Alternative",35,46,1610,1122,488
"1103","Park","Alternative",32,57,1824,1199,625
"1104","Park","Alternative",40,28,1120,996,124
"1105","Park","Alternative",40,44,1760,1108,652
"1106","Park","Alternative",35,36,1260,1052,208
"1107","Park","Alternative",35,40,1400,1080,320
"1108","Park","Alternative",35,45,1575,1115,460
"1109","Park","Alternative",40,32,1280,1024,256
"1110","Park","Alternative",40,30,1200,1010,190
"1111","Park","Alternative",40,40,1600,1080,520
"1112","Park","Alternative",40,34,1360,1038,322
"1113","Park","Alternative",35,46,1610,1122,488
"1114","Park","Alternative",32,56,1792,1192,600
"1115","Park","Alternative",40,32,1280,1024,256
"1116","Park","Alternative",32,50,1600,1150,450
"1117","Park","Alternative",32,67,2144,1269,875
"1118","Park","Alternative",40,32,1280,1024,256
"1119","Park","Alternative",32,62,1984,1234,750
"1120","Park","Alternative",35,43,1505,1101,404
"1121","Park","Alternative",32,56,1792,1192,600
"1122","Park","Alternative",40,32,1280,1024,256
"1123","Park","Alternative",40,25,1000,975,25
"1124","Park","Alternative",32,50,1600,1150,450
"1125","Park","Alternative",35,43,1505,1101,404
"1126","Park","Alternative",35,36,1260,1052,208
"1127","Park","Alternative",32,56,1792,1192,600
"1128","Park","Alternative",35,36,1260,1052,208
"1129","Park","Alternative",40,36,1440,1052,388
"1130","Park","Alternative",32,46,1472,1122,350
"1131","Park","Alternative",32,58,1856,1206,650
"1132","Park","Alternative",35,41,1435,1087,348
"1133","Park","Alternative",35,44,1540,1108,432
"1134","Park","Alternative",40,38,1520,1066,454
"1135","Park","Alternative",40,24,960,968,-8
"1136","Park","Alternative",35,44,1540,1108,432
"1137","Park","Alternative",35,44,1540,1108,432
"1138","Park","Alternative",32,58,1856,1206,650
"1139","Park","Alternative",32,50,1600,1150,450
"1140","Park","Alternative",40,38,1520,1066,454
"1141","Park","Alternative",35,51,1785,1157,628
"1142","Park","Alternative",40,22,880,954,-74
"1143","Park","Alternative",35,40,1400,1080,320
"1144","Park","Alternative",32,53,1696,1171,525
"1145","Park","Alternative",40,38,1520,1066,454
"1146","Park","Alternative",35,36,1260,1052,208
"1147","Park","Alternative",35,42,1470,1094,376
"1148","Park","Alternative",32,62,1984,1234,750
"1149","Park","Alternative",40,32,1280,1024,256
"1150","Park","Alternative",40,30,1200,1010,190
"1151","Park","Alternative",32,52,1664,1164,500
"1152","Park","Alternative",35,34,1190,1038,152
"1153","Park","Alternative",32,54,1728,1178,550
"1154","Park","Alternative",40,29,1160,1003,157
"1155","Park","Alternative",40,32,1280,1024,256
"1156","Park","Alternative",40,34,1360,1038,322
"1157","Park","Alternative",32,59,1888,1213,675
"1158","Park","Alternative",40,40,1600,1080,520
"1159","Park","Alternative",35,46,1610,1122,488
"1160","Park","Alternative",35,42,1470,1094,376
"1161","Park","Alternative",35,36,1260,1052,208
"1162","Park","Alternative",35,36,1260,1052,208
"1163","Park","Alternative",40,29,1160,1003,157
"1164","Park","Alternative",32,60,1920,1220,700
"1165","Park","Alternative",35,49,1715,1143,572
"1166","Park","Alternative",32,72,2304,1304,1000
"1167","Park","Alternative",35,44,1540,1108,432
"1168","Park","Alternative",32,74,2368,1318,1050
"1169","Park","Alternative",32,54,1728,1178,550
"1170","Park","Alternative",32,58,1856,1206,650
"1171","Park","Alternative",40,30,1200,1010,190
"1172","Park","Alternative",35,42,1470,1094,376
"1173","Park","Alternative",32,68,2176,1276,900
"1174","Park","Alternative",40,35,1400,1045,355
"1175","Park","Alternative",35,40,1400,1080,320
"1176","Park","Alternative",32,56,1792,1192,600
"1177","Park","Alternative",32,60,1920,1220,700
"1178","Park","Alternative",32,53,1696,1171,525
"1179","Park","Alternative",35,36,1260,1052,208
"1180","Park","Alternative",40,32,1280,1024,256
"1181","Park","Alternative",40,34,1360,1038,322
"1182","Park","Alternative",40,24,960,968,-8
"1183","Park","Alternative",32,49,1568,1143,425
"1184","Park","Alternative",35,43,1505,1101,404
"1185","Park","Alternative",32,66,2112,1262,850
"1186","Park","Alternative",40,30,1200,1010,190
"1187","Park","Alternative",35,41,1435,1087,348
"1188","Park","Alternative",35,48,1680,1136,544
"1189","Park","Alternative",40,20,800,940,-140
"1190","Park","Alternative",32,51,1632,1157,475
"1191","Park","Alternative",32,56,1792,1192,600
"1192","Park","Alternative",40,26,1040,982,58
"1193","Park","Alternative",35,46,1610,1122,488
"1194","Park","Alternative",35,42,1470,1094,376
"1195","Park","Alternative",40,37,1480,1059,421
"1196","Park","Alternative",35,40,1400,1080,320
"1197","Park","Alternative",32,54,1728,1178,550
"1198","Park","Alternative",32,58,1856,1206,650
"1199","Park","Alternative",40,23,920,961,-41
"1200","Park","Alternative",40,32,1280,1024,256
"1201","Park","Alternative",35,33,1155,1031,124
"1202","Park","Alternative",40,34,1360,1038,322
"1203","Park","Alternative",40,40,1600,1080,520
"1204","Park","Alternative",40,36,1440,1052,388
"1205","Park","Alternative",32,54,1728,1178,550
"1206","Park","Alternative",35,40,1400,1080,320
"1207","Park","Alternative",32,53,1696,1171,525
"1208","Park","Alternative",32,55,1760,1185,575
"1209","Park","Alternative",32,56,1792,1192,600
"1210","Park","Alternative",32,62,1984,1234,750
"1211","Park","Alternative",32,54,1728,1178,550
"1212","Park","Alternative",32,61,1952,1227,725
"1213","Park","Alternative",40,34,1360,1038,322
"1214","Park","Alternative",32,58,1856,1206,650
"1215","Park","Alternative",35,38,1330,1066,264
"1216","Park","Alternative",40,32,1280,1024,256
"1217","Park","Alternative",40,38,1520,1066,454
"1218","Park","Alternative",35,44,1540,1108,432
"1219","Park","Alternative",35,38,1330,1066,264
"1220","Park","Alternative",35,34,1190,1038,152
"1221","Park","Alternative",32,58,1856,1206,650
"1222","Park","Alternative",40,32,1280,1024,256
"1223","Park","Alternative",40,29,1160,1003,157
"1224","Park","Alternative",35,40,1400,1080,320
"1225","Park","Alternative",40,36,1440,1052,388
"1226","Park","Alternative",32,58,1856,1206,650
"1227","Park","Alternative",32,46,1472,1122,350
"1228","Park","Alternative",32,59,1888,1213,675
"1229","Park","Alternative",35,39,1365,1073,292
"1230","Park","Alternative",32,48,1536,1136,400
"1231","Park","Alternative",35,44,1540,1108,432
"1232","Park","Alternative",40,22,880,954,-74
"1233","Park","Alternative",32,64,2048,1248,800
"1234","Park","Alternative",35,42,1470,1094,376
"1235","Park","Alternative",32,60,1920,1220,700
"1236","Park","Alternative",35,34,1190,1038,152
"1237","Park","Alternative",40,33,1320,1031,289
"1238","Park","Alternative",40,21,840,947,-107
"1239","Park","Alternative",40,42,1680,1094,586
"1240","Park","Alternative",35,46,1610,1122,488
"1241","Park","Alternative",35,42,1470,1094,376
"1242","Park","Alternative",35,36,1260,1052,208
"1243","Park","Alternative",40,36,1440,1052,388
"1244","Park","Alternative",32,58,1856,1206,650
"1245","Park","Alternative",35,44,1540,1108,432
"1246","Park","Alternative",32,64,2048,1248,800
"1247","Park","Alternative",35,44,1540,1108,432
"1248","Park","Alternative",40,30,1200,1010,190
"1249","Park","Alternative",40,30,1200,1010,190
"1250","Park","Alternative",40,32,1280,1024,256
"1251","Park","Alternative",40,36,1440,1052,388
"1252","Park","Alternative",32,60,1920,1220,700
"1253","Park","Alternative",40,38,1520,1066,454
"1254","Park","Alternative",40,34,1360,1038,322
"1255","Park","Alternative",32,60,1920,1220,700
"1256","Park","Alternative",32,51,1632,1157,475
"1257","Park","Alternative",35,42,1470,1094,376
"1258","Park","Alternative",35,48,1680,1136,544
"1259","Park","Alternative",35,38,1330,1066,264
"1260","Park","Alternative",35,46,1610,1122,488
"1261","Park","Alternative",35,49,1715,1143,572
"1262","Park","Alternative",32,60,1920,1220,700
"1263","Park","Alternative",35,40,1400,1080,320
"1264","Park","Alternative",40,40,1600,1080,520
"1265","Park","Alternative",40,26,1040,982,58
"1266","Park","Alternative",32,52,1664,1164,500
"1267","Park","Alternative",40,32,1280,1024,256
"1268","Park","Alternative",35,37,1295,1059,236
"1269","Park","Alternative",40,34,1360,1038,322
"1270","Park","Alternative",32,56,1792,1192,600
"1271","Park","Alternative",32,66,2112,1262,850
"1272","Park","Alternative",40,32,1280,1024,256
"1273","Park","Alternative",32,58,1856,1206,650
"1274","Park","Alternative",35,52,1820,1164,656
"1275","Park","Alternative",40,40,1600,1080,520
"1276","Park","Alternative",40,34,1360,1038,322
"1277","Park","Alternative",40,38,1520,1066,454
"1278","Park","Alternative",32,60,1920,1220,700
"1279","Park","Alternative",35,44,1540,1108,432
"1280","Park","Alternative",32,57,1824,1199,625
"1281","Park","Alternative",35,44,1540,1108,432
"1282","Park","Alternative",35,42,1470,1094,376
"1283","Park","Alternative",40,42,1680,1094,586
"1284","Park","Alternative",35,40,1400,1080,320
"1285","Park","Alternative",35,50,1750,1150,600
"1286","Park","Alternative",40,38,1520,1066,454
"1287","Park","Alternative",35,40,1400,1080,320
"1288","Park","Alternative",40,33,1320,1031,289
"1289","Park","Alternative",40,33,1320,1031,289
"1290","Park","Alternative",40,30,1200,1010,190
"1291","Park","Alternative",32,56,1792,1192,600
"1292","Park","Alternative",32,57,1824,1199,625
"1293","Park","Alternative",32,56,1792,1192,600
"1294","Park","Alternative",35,39,1365,1073,292
"1295","Park","Alternative",32,64,2048,1248,800
"1296","Park","Alternative",35,50,1750,1150,600
"1297","Park","Alternative",32,57,1824,1199,625
"1298","Park","Alternative",40,30,1200,1010,190
"1299","Park","Alternative",32,58,1856,1206,650
"1300","Park","Alternative",35,48,1680,1136,544
"1301","Park","Alternative",40,38,1520,1066,454
"1302","Park","Alternative",32,48,1536,1136,400
"1303","Park","Alternative",35,41,1435,1087,348
"1304","Park","Alternative",40,30,1200,1010,190
"1305","Park","Alternative",35,42,1470,1094,376
"1306","Park","Alternative",32,60,1920,1220,700
"1307","Park","Alternative",35,38,1330,1066,264
"1308","Park","Alternative",40,24,960,968,-8
"1309","Park","Alternative",32,60,1920,1220,700
"1310","Park","Alternative",40,30,1200,1010,190
"1311","Park","Alternative",32,66,2112,1262,850
"1312","Park","Alternative",35,42,1470,1094,376
"1313","Park","Alternative",32,68,2176,1276,900
"1314","Park","Alternative",32,52,1664,1164,500
"1315","Park","Alternative",35,43,1505,1101,404
"1316","Park","Alternative",35,37,1295,1059,236
"1317","Park","Alternative",32,60,1920,1220,700
"1318","Park","Alternative",40,36,1440,1052,388
"1319","Park","Alternative",35,50,1750,1150,600
"1320","Park","Alternative",40,30,1200,1010,190
"1321","Park","Alternative",32,54,1728,1178,550
"1322","Park","Alternative",32,52,1664,1164,500
"1323","Park","Alternative",32,60,1920,1220,700
"1324","Park","Alternative",32,58,1856,1206,650
"1325","Park","Alternative",35,34,1190,1038,152
"1326","Park","Alternative",40,19,760,933,-173
"1327","Park","Alternative",40,30,1200,1010,190
"1328","Park","Alternative",32,60,1920,1220,700
"1329","Park","Alternative",35,46,1610,1122,488
"1330","Park","Alternative",32,57,1824,1199,625
"1331","Park","Alternative",35,40,1400,1080,320
"1332","Park","Alternative",32,63,2016,1241,775
"1333","Park","Alternative",32,54,1728,1178,550
"1334","Park","Alternative",40,30,1200,1010,190
"1335","Park","Alternative",40,38,1520,1066,454
"1336","Park","Alternative",35,34,1190,1038,152
"1337","Park","Alternative",40,37,1480,1059,421
"1338","Park","Alternative",35,42,1470,1094,376
"1339","Park","Alternative",40,34,1360,1038,322
"1340","Park","Alternative",40,38,1520,1066,454
"1341","Park","Alternative",32,56,1792,1192,600
"1342","Park","Alternative",40,36,1440,1052,388
"1343","Park","Alternative",40,31,1240,1017,223
"1344","Park","Alternative",32,58,1856,1206,650
"1345","Park","Alternative",35,38,1330,1066,264
"1346","Park","Alternative",32,68,2176,1276,900
"1347","Park","Alternative",40,32,1280,1024,256
"1348","Park","Alternative",40,38,1520,1066,454
"1349","Park","Alternative",35,33,1155,1031,124
"1350","Park","Alternative",35,46,1610,1122,488
"1351","Park","Alternative",35,48,1680,1136,544
"1352","Park","Alternative",35,44,1540,1108,432
"1353","Park","Alternative",35,48,1680,1136,544
"1354","Park","Alternative",40,30,1200,1010,190
"1355","Park","Alternative",40,36,1440,1052,388
"1356","Park","Alternative",32,64,2048,1248,800
"1357","Park","Alternative",35,47,1645,1129,516
"1358","Park","Alternative",40,46,1840,1122,718
"1359","Park","Alternative",32,66,2112,1262,850
"1360","Park","Alternative",32,56,1792,1192,600
"1361","Park","Alternative",35,44,1540,1108,432
"1362","Park","Alternative",40,30,1200,1010,190
"1363","Park","Alternative",32,53,1696,1171,525
"1364","Park","Alternative",40,37,1480,1059,421
"1365","Park","Alternative",35,38,1330,1066,264
"1366","Park","Alternative",35,56,1960,1192,768
"1367","Park","Alternative",32,60,1920,1220,700
"1368","Park","Alternative",32,54,1728,1178,550
"1369","Park","Alternative",32,62,1984,1234,750
"1370","Park","Alternative",35,40,1400,1080,320
"1371","Park","Alternative",32,70,2240,1290,950
"1372","Park","Alternative",35,47,1645,1129,516
"1373","Park","Alternative",35,55,1925,1185,740
"1374","Park","Alternative",40,29,1160,1003,157
"1375","Park","Alternative",40,32,1280,1024,256
"1376","Park","Alternative",40,38,1520,1066,454
"1377","Park","Alternative",35,47,1645,1129,516
"1378","Park","Alternative",35,44,1540,1108,432
"1379","Park","Alternative",40,35,1400,1045,355
"1380","Park","Alternative",32,57,1824,1199,625
"1381","Park","Alternative",35,33,1155,1031,124
"1382","Zoo","Alternative",35,4,140,828,-688
"1383","Zoo","Alternative",35,22,770,954,-184
"1384","CityHall","Alternative",32,33,1056,1031,25
"1385","Zoo","Alternative",32,40,1280,1080,200
"1386","Park","Alternative",32,34,1088,1038,50
"1387","Park","Alternative",32,44,1408,1108,300
"1388","CityHall","Alternative",35,20,700,940,-240
"1389","Park","Alternative",35,31,1085,1017,68
"1390","Park","Alternative",32,38,1216,1066,150
"1391","CityHall","Alternative",35,34,1190,1038,152
"1392","CityHall","Alternative",35,9,315,863,-548
"1393","Zoo","Alternative",32,38,1216,1066,150
"1394","CityHall","Alternative",32,8,256,856,-600
"1395","CityHall","Alternative",32,50,1600,1150,450
"1396","Park","Alternative",35,34,1190,1038,152
"1397","Zoo","Alternative",32,6,192,842,-650
"1398","Park","Alternative",32,40,1280,1080,200
"1399","Zoo","Alternative",32,14,448,898,-450
"1400","CityHall","Alternative",32,44,1408,1108,300
"1401","Zoo","Alternative",35,6,210,842,-632
"1402","CityHall","Alternative",35,25,875,975,-100
"1403","Park","Alternative",35,20,700,940,-240
"1404","Zoo","Alternative",35,31,1085,1017,68
"1405","Business","HipHop",32,34,1088,1038,50
"1406","Business","HipHop",35,24,840,968,-128
"1407","Business","HipHop",32,38,1216,1066,150
"1408","Business","HipHop",32,33,1056,1031,25
"1409","Business","HipHop",35,26,910,982,-72
"1410","Business","HipHop",32,34,1088,1038,50
"1411","Business","HipHop",35,29,1015,1003,12
"1412","Business","HipHop",35,18,630,926,-296
"1413","Park","Alternative",40,32,1280,1024,256
"1414","Park","Alternative",40,35,1400,1045,355
"1415","Park","Alternative",32,54,1728,1178,550
"1416","Park","Alternative",35,46,1610,1122,488
"1417","Park","Alternative",32,66,2112,1262,850
"1418","Park","Alternative",32,63,2016,1241,775
"1419","Park","Alternative",40,34,1360,1038,322
"1420","Park","Alternative",35,40,1400,1080,320
"1421","Park","Alternative",40,36,1440,1052,388
"1422","Park","Alternative",40,37,1480,1059,421
"1423","Park","Alternative",40,28,1120,996,124
"1424","Park","Alternative",32,64,2048,1248,800
"1425","Park","Alternative",40,28,1120,996,124
"1426","Park","Alternative",35,44,1540,1108,432
"1427","Park","Alternative",35,39,1365,1073,292
"1428","Park","Alternative",35,44,1540,1108,432
"1429","Park","Alternative",35,32,1120,1024,96
"1430","Park","Alternative",32,58,1856,1206,650
"1431","Park","Alternative",35,36,1260,1052,208
"1432","Park","Alternative",40,24,960,968,-8
"1433","Park","Alternative",32,54,1728,1178,550
"1434","Park","Alternative",35,38,1330,1066,264
"1435","Park","Alternative",40,22,880,954,-74
"1436","Park","Alternative",32,52,1664,1164,500
"1437","Park","Alternative",40,34,1360,1038,322
"1438","Park","Alternative",35,44,1540,1108,432
"1439","Park","Alternative",32,68,2176,1276,900
"1440","Park","Alternative",32,50,1600,1150,450
"1441","Park","Alternative",32,52,1664,1164,500
"1442","Park","Alternative",35,36,1260,1052,208
"1443","Park","Alternative",40,39,1560,1073,487
"1444","Park","Alternative",35,49,1715,1143,572
"1445","Park","Alternative",35,52,1820,1164,656
"1446","Park","Alternative",40,39,1560,1073,487
"1447","Park","Alternative",35,55,1925,1185,740
"1448","Park","Alternative",32,79,2528,1353,1175
"1449","Park","Alternative",32,72,2304,1304,1000
"1450","Park","Alternative",35,57,1995,1199,796
"1451","Park","Alternative",40,42,1680,1094,586
"1452","Park","Alternative",40,42,1680,1094,586
"1453","Park","Alternative",40,33,1320,1031,289
"1454","Park","Alternative",35,41,1435,1087,348
"1455","Park","Alternative",35,44,1540,1108,432
"1456","Park","Alternative",40,36,1440,1052,388
"1457","Park","Alternative",40,38,1520,1066,454
"1458","Park","Alternative",32,66,2112,1262,850
"1459","Park","Alternative",32,66,2112,1262,850
"1460","Park","Alternative",35,42,1470,1094,376
"1461","Park","Alternative",35,52,1820,1164,656
"1462","Park","Alternative",32,74,2368,1318,1050
"1463","Park","Alternative",35,48,1680,1136,544
"1464","Park","Alternative",40,36,1440,1052,388
"1465","Park","Alternative",32,67,2144,1269,875
"1466","Park","Alternative",40,40,1600,1080,520
"1467","Park","Alternative",32,66,2112,1262,850
"1468","Park","Alternative",32,64,2048,1248,800
"1469","Park","Alternative",40,45,1800,1115,685
"1470","Park","Alternative",32,75,2400,1325,1075
"1471","Park","Alternative",35,57,1995,1199,796
"1472","Park","Alternative",32,62,1984,1234,750
"1473","Park","Alternative",40,14,560,898,-338
"1474","Park","Alternative",32,66,2112,1262,850
"1475","Park","Alternative",40,22,880,954,-74
"1476","Park","Alternative",35,42,1470,1094,376
"1477","Park","Alternative",40,21,840,947,-107
"1478","Park","Alternative",40,28,1120,996,124
"1479","Park","Alternative",35,36,1260,1052,208
"1480","Park","Alternative",32,60,1920,1220,700
"1481","Park","Alternative",32,32,1024,1024,0
"1482","Park","Alternative",40,32,1280,1024,256
"1483","Park","Alternative",40,24,960,968,-8
"1484","Park","Alternative",32,60,1920,1220,700
"1485","Park","Alternative",40,32,1280,1024,256
"1486","Park","Alternative",35,50,1750,1150,600
"1487","Park","Alternative",32,37,1184,1059,125
"1488","Park","Alternative",40,32,1280,1024,256
"1489","Park","Alternative",40,32,1280,1024,256
"1490","Park","Alternative",32,42,1344,1094,250
"1491","Park","Alternative",35,49,1715,1143,572
"1492","Park","Alternative",40,18,720,926,-206
"1493","Park","Alternative",32,66,2112,1262,850
"1494","Park","Alternative",32,41,1312,1087,225
"1495","Park","Alternative",32,64,2048,1248,800
"1496","Park","Alternative",40,38,1520,1066,454
"1497","Park","Alternative",32,36,1152,1052,100
"1498","Park","Alternative",35,50,1750,1150,600
"1499","Park","Alternative",35,28,980,996,-16
"1500","Park","Alternative",40,41,1640,1087,553
"1501","Park","Alternative",32,28,896,996,-100
"1502","Park","Alternative",32,65,2080,1255,825
"1503","Park","Alternative",35,24,840,968,-128
"1504","Park","Alternative",32,68,2176,1276,900
"1505","Park","Alternative",35,20,700,940,-240
"1506","Park","Alternative",32,66,2112,1262,850
"1507","Park","Alternative",40,21,840,947,-107
"1508","Park","Alternative",40,48,1920,1136,784
"1509","Park","Alternative",35,22,770,954,-184
"1510","Park","Alternative",35,42,1470,1094,376
"1511","Park","Alternative",32,38,1216,1066,150
"1512","Park","Alternative",40,40,1600,1080,520
"1513","Park","Alternative",40,20,800,940,-140
"1514","Park","Alternative",32,22,704,954,-250
"1515","Park","Alternative",35,48,1680,1136,544
"1516","Park","Alternative",40,28,1120,996,124
"1517","Park","Alternative",32,66,2112,1262,850
"1518","Park","Alternative",32,37,1184,1059,125
"1519","Park","Alternative",35,56,1960,1192,768
"1520","Park","Alternative",35,26,910,982,-72
"1521","Park","Alternative",35,22,770,954,-184
"1522","Park","Alternative",32,64,2048,1248,800
"1523","Park","Alternative",35,26,910,982,-72
"1524","Park","Alternative",35,56,1960,1192,768
"1525","Park","Alternative",32,34,1088,1038,50
"1526","Park","Alternative",35,54,1890,1178,712
"1527","Park","Alternative",35,34,1190,1038,152
"1528","Park","Alternative",40,39,1560,1073,487
"1529","Park","Alternative",40,26,1040,982,58
"1530","Park","Alternative",40,46,1840,1122,718
"1531","Park","Alternative",35,28,980,996,-16
"1532","Park","Alternative",35,48,1680,1136,544
"1533","Park","Alternative",40,29,1160,1003,157
"1534","Park","Alternative",32,74,2368,1318,1050
"1535","Park","Alternative",40,36,1440,1052,388
"1536","Park","Alternative",32,62,1984,1234,750
"1537","Park","Alternative",35,52,1820,1164,656
"1538","Park","Alternative",35,47,1645,1129,516
"1539","Park","Alternative",32,74,2368,1318,1050
"1540","Park","Alternative",40,38,1520,1066,454
"1541","Park","Alternative",35,52,1820,1164,656
"1542","Park","Alternative",40,35,1400,1045,355
"1543","Park","Alternative",35,54,1890,1178,712
"1544","Park","Alternative",40,31,1240,1017,223
"1545","Park","Alternative",35,52,1820,1164,656
"1546","Park","Alternative",40,35,1400,1045,355
"1547","Park","Alternative",35,48,1680,1136,544
"1548","Park","Alternative",32,66,2112,1262,850
"1549","Park","Alternative",40,20,800,940,-140
"1550","Park","Alternative",40,32,1280,1024,256
"1551","Park","Alternative",32,63,2016,1241,775
"1552","Park","Alternative",32,75,2400,1325,1075
"1553","Park","Alternative",32,65,2080,1255,825
"1554","Park","Alternative",35,53,1855,1171,684
"1555","Park","Alternative",40,37,1480,1059,421
"1556","Park","Alternative",32,75,2400,1325,1075
"1557","Park","Alternative",35,52,1820,1164,656
"1558","Park","Alternative",35,46,1610,1122,488
"1559","Park","Alternative",32,72,2304,1304,1000
"1560","Park","Alternative",35,46,1610,1122,488
"1561","Park","Alternative",32,70,2240,1290,950
"1562","Park","Alternative",40,28,1120,996,124
"1563","Park","Alternative",32,68,2176,1276,900
"1564","Park","Alternative",32,76,2432,1332,1100
"1565","Park","Alternative",40,32,1280,1024,256
"1566","Park","Alternative",35,52,1820,1164,656
"1567","Park","Alternative",32,63,2016,1241,775
"1568","Park","Alternative",40,25,1000,975,25
"1569","Park","Alternative",40,30,1200,1010,190
"1570","Park","Alternative",40,30,1200,1010,190
"1571","Park","Alternative",35,40,1400,1080,320
"1572","Park","Alternative",32,69,2208,1283,925
"1573","Park","Alternative",32,70,2240,1290,950
"1574","Park","Alternative",40,38,1520,1066,454
"1575","Park","Alternative",40,30,1200,1010,190
"1576","Park","Alternative",40,34,1360,1038,322
"1577","Park","Alternative",40,31,1240,1017,223
"1578","Park","Alternative",35,39,1365,1073,292
"1579","Park","Alternative",32,70,2240,1290,950
"1580","Park","Alternative",40,34,1360,1038,322
"1581","Park","Alternative",35,41,1435,1087,348
"1582","Park","Alternative",32,71,2272,1297,975
"1583","Park","Alternative",32,76,2432,1332,1100
"1584","Park","Alternative",35,44,1540,1108,432
"1585","Park","Alternative",32,68,2176,1276,900
"1586","Park","Alternative",32,72,2304,1304,1000
"1587","Park","Alternative",35,50,1750,1150,600
"1588","Park","Alternative",40,35,1400,1045,355
"1589","Park","Alternative",35,50,1750,1150,600
"1590","Park","Alternative",35,42,1470,1094,376
"1591","Park","Alternative",35,52,1820,1164,656
"1592","Park","Alternative",35,46,1610,1122,488
"1593","Park","Alternative",35,54,1890,1178,712
"1594","Park","Alternative",35,52,1820,1164,656
"1595","Park","Alternative",32,71,2272,1297,975
"1596","Park","Alternative",40,40,1600,1080,520
"1597","Park","Alternative",40,34,1360,1038,322
"1598","Park","Alternative",40,32,1280,1024,256
"1599","Park","Alternative",40,30,1200,1010,190
"1600","Park","Alternative",32,74,2368,1318,1050
"1601","Park","Alternative",32,68,2176,1276,900
"1602","Park","Alternative",35,44,1540,1108,432
"1603","Park","Alternative",32,68,2176,1276,900
"1604","Park","Alternative",35,52,1820,1164,656
"1605","Park","Alternative",35,54,1890,1178,712
"1606","Park","Alternative",40,28,1120,996,124
"1607","Park","Alternative",35,46,1610,1122,488
"1608","Park","Alternative",35,38,1330,1066,264
"1609","Park","Alternative",32,66,2112,1262,850
"1610","Park","Alternative",40,34,1360,1038,322
"1611","Park","Alternative",40,26,1040,982,58
"1612","Park","Alternative",32,64,2048,1248,800
"1613","Park","Alternative",35,53,1855,1171,684
"1614","Park","Alternative",40,36,1440,1052,388
"1615","Park","Alternative",32,74,2368,1318,1050
"1616","Park","Alternative",35,46,1610,1122,488
"1617","Park","Alternative",40,36,1440,1052,388
"1618","Park","Alternative",32,68,2176,1276,900
"1619","Park","Alternative",32,72,2304,1304,1000
"1620","Park","Alternative",40,28,1120,996,124
"1621","Park","Alternative",32,70,2240,1290,950
"1622","Park","Alternative",35,48,1680,1136,544
"1623","Park","Alternative",40,38,1520,1066,454
"1624","Park","Alternative",40,32,1280,1024,256
"1625","Park","Alternative",35,42,1470,1094,376
"1626","Park","Alternative",32,78,2496,1346,1150
"1627","Park","Alternative",35,41,1435,1087,348
"1628","Park","Alternative",32,76,2432,1332,1100
"1629","Park","Alternative",32,62,1984,1234,750
"1630","Park","Alternative",35,48,1680,1136,544
"1631","Park","Alternative",35,54,1890,1178,712
"1632","Park","Alternative",35,46,1610,1122,488
"1633","Park","Alternative",35,45,1575,1115,460
"1634","Park","Alternative",35,48,1680,1136,544
"1635","Park","Alternative",40,41,1640,1087,553
"1636","Park","Alternative",32,63,2016,1241,775
"1637","Park","Alternative",40,28,1120,996,124
"1638","Park","Alternative",40,33,1320,1031,289
"1639","Park","Alternative",32,70,2240,1290,950
"1640","Park","Alternative",32,73,2336,1311,1025
"1641","Park","Alternative",32,79,2528,1353,1175
"1642","Park","Alternative",40,27,1080,989,91
"1643","Park","Alternative",40,34,1360,1038,322
"1644","Park","Alternative",40,23,920,961,-41
"1645","Park","Alternative",35,40,1400,1080,320
"1646","Park","Alternative",40,36,1440,1052,388
"1647","Park","Alternative",35,54,1890,1178,712
"1648","Park","Alternative",35,50,1750,1150,600
"1649","Park","Alternative",32,67,2144,1269,875
"1650","Park","Alternative",32,68,2176,1276,900
"1651","Park","Alternative",32,72,2304,1304,1000
"1652","Park","Alternative",40,28,1120,996,124
"1653","Park","Alternative",40,22,880,954,-74
"1654","Park","Alternative",32,70,2240,1290,950
"1655","Park","Alternative",40,33,1320,1031,289
"1656","Park","Alternative",35,40,1400,1080,320
"1657","Park","Alternative",35,52,1820,1164,656
"1658","Park","Alternative",35,60,2100,1220,880
"1659","Park","Alternative",32,70,2240,1290,950
"1660","Park","Alternative",32,66,2112,1262,850
"1661","Park","Alternative",32,64,2048,1248,800
"1662","Park","Alternative",32,78,2496,1346,1150
"1663","Park","Alternative",32,78,2496,1346,1150
"1664","Park","Alternative",35,48,1680,1136,544
"1665","Park","Alternative",40,43,1720,1101,619
"1666","Park","Alternative",35,56,1960,1192,768
"1667","Park","Alternative",40,33,1320,1031,289
"1668","Park","Alternative",40,24,960,968,-8
"1669","Park","Alternative",32,72,2304,1304,1000
"1670","Park","Alternative",35,45,1575,1115,460
"1671","Park","Alternative",40,26,1040,982,58
"1672","Park","Alternative",40,32,1280,1024,256
"1673","Park","Alternative",32,70,2240,1290,950
"1674","Park","Alternative",40,27,1080,989,91
"1675","Park","Alternative",32,76,2432,1332,1100
"1676","Park","Alternative",35,56,1960,1192,768
"1677","Park","Alternative",40,42,1680,1094,586
"1678","Park","Alternative",35,58,2030,1206,824
"1679","Park","Alternative",35,56,1960,1192,768
"1680","Park","Alternative",35,56,1960,1192,768
"1681","Park","Alternative",32,62,1984,1234,750
"1682","Park","Alternative",40,38,1520,1066,454
"1683","Park","Alternative",40,26,1040,982,58
"1684","Park","Alternative",35,46,1610,1122,488
"1685","Park","Alternative",40,26,1040,982,58
"1686","Park","Alternative",32,66,2112,1262,850
"1687","Park","Alternative",32,73,2336,1311,1025
"1688","Park","Alternative",35,51,1785,1157,628
"1689","Park","Alternative",35,48,1680,1136,544
"1690","Park","Alternative",40,26,1040,982,58
"1691","Park","Alternative",35,55,1925,1185,740
"1692","Park","Alternative",40,28,1120,996,124
"1693","Park","Alternative",35,47,1645,1129,516
"1694","Park","Alternative",32,78,2496,1346,1150
"1695","Park","Alternative",32,64,2048,1248,800
"1696","Park","Alternative",40,26,1040,982,58
"1697","Park","Alternative",40,34,1360,1038,322
"1698","Park","Alternative",40,30,1200,1010,190
"1699","Park","Alternative",35,50,1750,1150,600
"1700","Park","Alternative",32,72,2304,1304,1000
"1701","Park","Alternative",32,74,2368,1318,1050
"1702","Park","Alternative",32,76,2432,1332,1100
"1703","Park","Alternative",40,26,1040,982,58
"1704","Park","Alternative",35,48,1680,1136,544
"1705","Park","Alternative",32,75,2400,1325,1075
"1706","Park","Alternative",40,30,1200,1010,190
"1707","Park","Alternative",35,44,1540,1108,432
"1708","Park","Alternative",32,72,2304,1304,1000
"1709","Park","Alternative",32,66,2112,1262,850
"1710","Park","Alternative",35,46,1610,1122,488
"1711","Park","Alternative",40,32,1280,1024,256
"1712","Park","Alternative",35,58,2030,1206,824
"1713","Park","Alternative",40,36,1440,1052,388
"1714","Park","Alternative",35,38,1330,1066,264
"1715","Park","Alternative",40,42,1680,1094,586
"1716","Park","Alternative",35,42,1470,1094,376
"1717","Park","Alternative",35,48,1680,1136,544
"1718","Park","Alternative",35,54,1890,1178,712
"1719","Park","Alternative",32,68,2176,1276,900
"1720","Park","Alternative",40,39,1560,1073,487
"1721","Park","Alternative",40,23,920,961,-41
"1722","Park","Alternative",35,38,1330,1066,264
"1723","Park","Alternative",35,48,1680,1136,544
"1724","Park","Alternative",35,48,1680,1136,544
"1725","Park","Alternative",32,72,2304,1304,1000
"1726","Park","Alternative",32,77,2464,1339,1125
"1727","Park","Alternative",32,74,2368,1318,1050
"1728","Park","Alternative",32,78,2496,1346,1150
"1729","Park","Alternative",40,38,1520,1066,454
"1730","Park","Alternative",32,60,1920,1220,700
"1731","Park","Alternative",40,22,880,954,-74
"1732","Park","Alternative",35,44,1540,1108,432
"1733","Park","Alternative",40,30,1200,1010,190
"1734","Park","Alternative",32,78,2496,1346,1150
"1735","Park","Alternative",32,68,2176,1276,900
"1736","Park","Alternative",40,31,1240,1017,223
"1737","Park","Alternative",35,39,1365,1073,292
"1738","Park","Alternative",40,38,1520,1066,454
"1739","Park","Alternative",32,64,2048,1248,800
"1740","Park","Alternative",32,64,2048,1248,800
"1741","Park","Alternative",40,28,1120,996,124
"1742","Park","Alternative",35,33,1155,1031,124
"1743","Park","Alternative",35,51,1785,1157,628
"1744","Park","Alternative",40,30,1200,1010,190
"1745","Park","Alternative",40,33,1320,1031,289
"1746","Park","Alternative",32,71,2272,1297,975
"1747","Park","Alternative",35,46,1610,1122,488
"1748","Park","Alternative",32,64,2048,1248,800
"1749","Park","Alternative",32,70,2240,1290,950
"1750","Park","Alternative",35,50,1750,1150,600
"1751","Park","Alternative",35,57,1995,1199,796
"1752","Park","Alternative",35,50,1750,1150,600
"1753","Park","Alternative",40,27,1080,989,91
"1754","Park","Alternative",40,26,1040,982,58
"1755","Park","Alternative",40,33,1320,1031,289
"1756","Park","Alternative",40,27,1080,989,91
"1757","Park","Alternative",35,44,1540,1108,432
"1758","Park","Alternative",32,75,2400,1325,1075
"1759","Park","Alternative",35,44,1540,1108,432
"1760","Park","Alternative",40,26,1040,982,58
"1761","Park","Alternative",40,35,1400,1045,355
"1762","Park","Alternative",35,54,1890,1178,712
"1763","Park","Alternative",32,72,2304,1304,1000
"1764","Park","Alternative",32,74,2368,1318,1050
"1765","Park","Alternative",40,36,1440,1052,388
"1766","Park","Alternative",32,72,2304,1304,1000
"1767","Park","Alternative",32,58,1856,1206,650
"1768","Park","Alternative",35,47,1645,1129,516
"1769","Park","Alternative",40,35,1400,1045,355
"1770","Park","Alternative",32,64,2048,1248,800
"1771","Park","Alternative",32,75,2400,1325,1075
"1772","Park","Alternative",35,52,1820,1164,656
"1773","Park","Alternative",35,46,1610,1122,488
"1774","Park","Alternative",35,50,1750,1150,600
"1775","Park","Alternative",32,66,2112,1262,850
"1776","Park","Alternative",32,63,2016,1241,775
"1777","Park","Alternative",40,44,1760,1108,652
"1778","Park","Alternative",32,74,2368,1318,1050
"1779","Park","Alternative",35,42,1470,1094,376
"1780","Park","Alternative",35,49,1715,1143,572
"1781","Park","Alternative",35,54,1890,1178,712
"1782","Park","Alternative",40,40,1600,1080,520
"1783","Park","Alternative",32,73,2336,1311,1025
"1784","Park","Alternative",40,32,1280,1024,256
"1785","Park","Alternative",40,31,1240,1017,223
"1786","Park","Alternative",32,72,2304,1304,1000
"1787","Park","Alternative",40,41,1640,1087,553
"1788","Park","Alternative",35,44,1540,1108,432
"1789","Park","Alternative",35,52,1820,1164,656
"1790","Park","Alternative",40,32,1280,1024,256
"1791","Park","Alternative",32,74,2368,1318,1050
"1792","Park","Alternative",32,81,2592,1367,1225
"1793","Park","Alternative",40,32,1280,1024,256
"1794","Park","Alternative",35,52,1820,1164,656
"1795","Park","Alternative",32,70,2240,1290,950
"1796","Park","Alternative",32,74,2368,1318,1050
"1797","Park","Alternative",32,71,2272,1297,975
"1798","Park","Alternative",40,36,1440,1052,388
"1799","Park","Alternative",40,38,1520,1066,454
"1800","Park","Alternative",35,54,1890,1178,712
"1801","Park","Alternative",35,54,1890,1178,712
"1802","Park","Alternative",40,34,1360,1038,322
"1803","Park","Alternative",40,29,1160,1003,157
"1804","Park","Alternative",32,70,2240,1290,950
"1805","Park","Alternative",32,64,2048,1248,800
"1806","Park","Alternative",40,29,1160,1003,157
"1807","Park","Alternative",32,76,2432,1332,1100
"1808","Park","Alternative",40,36,1440,1052,388
"1809","Park","Alternative",32,70,2240,1290,950
"1810","Park","Alternative",35,48,1680,1136,544
"1811","Park","Alternative",32,72,2304,1304,1000
"1812","Park","Alternative",35,45,1575,1115,460
"1813","Park","Alternative",35,48,1680,1136,544
"1814","Park","Alternative",40,35,1400,1045,355
"1815","Park","Alternative",40,36,1440,1052,388
"1816","Park","Alternative",40,36,1440,1052,388
"1817","Park","Alternative",40,26,1040,982,58
"1818","Park","Alternative",40,34,1360,1038,322
"1819","Park","Alternative",40,31,1240,1017,223
"1820","Park","Alternative",35,50,1750,1150,600
"1821","Park","Alternative",35,54,1890,1178,712
"1822","Park","Alternative",35,50,1750,1150,600
"1823","Park","Alternative",35,46,1610,1122,488
"1824","Park","Alternative",35,48,1680,1136,544
"1825","Park","Alternative",35,40,1400,1080,320
"1826","Park","Alternative",40,38,1520,1066,454
"1827","Park","Alternative",35,57,1995,1199,796
"1828","Park","Alternative",32,72,2304,1304,1000
"1829","Park","Alternative",32,66,2112,1262,850
"1830","Park","Alternative",32,70,2240,1290,950
"1831","Park","Alternative",32,56,1792,1192,600
"1832","Park","Alternative",32,74,2368,1318,1050
"1833","Park","Alternative",40,34,1360,1038,322
"1834","Park","Alternative",32,70,2240,1290,950
"1835","Park","Alternative",32,70,2240,1290,950
"1836","Park","Alternative",40,28,1120,996,124
"1837","Park","Alternative",40,37,1480,1059,421
"1838","Park","Alternative",35,48,1680,1136,544
"1839","Park","Alternative",32,71,2272,1297,975
"1840","Park","Alternative",35,50,1750,1150,600
"1841","Park","Alternative",32,75,2400,1325,1075
"1842","Park","Alternative",35,42,1470,1094,376
"1843","Park","Alternative",40,34,1360,1038,322
"1844","Park","Alternative",35,48,1680,1136,544
"1845","Park","Alternative",35,39,1365,1073,292
"1846","Park","Alternative",32,68,2176,1276,900
"1847","Park","Alternative",40,32,1280,1024,256
"1848","Park","Alternative",35,44,1540,1108,432
"1849","Park","Alternative",40,32,1280,1024,256
"1850","Park","Alternative",40,24,960,968,-8
"1851","Park","Alternative",40,29,1160,1003,157
"1852","Park","Alternative",32,72,2304,1304,1000
"1853","Park","Alternative",32,72,2304,1304,1000
"1854","Park","Alternative",35,44,1540,1108,432
"1855","Park","Alternative",40,32,1280,1024,256
"1856","Park","Alternative",32,64,2048,1248,800
"1857","Park","Alternative",32,70,2240,1290,950
"1858","Park","Alternative",32,72,2304,1304,1000
"1859","Park","Alternative",35,42,1470,1094,376
"1860","Park","Alternative",35,42,1470,1094,376
"1861","Park","Alternative",35,46,1610,1122,488
"1862","Park","Alternative",40,38,1520,1066,454
"1863","Park","Alternative",40,24,960,968,-8
"1864","Park","Alternative",35,48,1680,1136,544
"1865","Park","Alternative",32,69,2208,1283,925
"1866","Park","Alternative",32,74,2368,1318,1050
"1867","Park","Alternative",40,30,1200,1010,190
"1868","Park","Alternative",40,32,1280,1024,256
"1869","Park","Alternative",32,72,2304,1304,1000
"1870","Park","Alternative",32,78,2496,1346,1150
"1871","Park","Alternative",35,44,1540,1108,432
"1872","Park","Alternative",35,48,1680,1136,544
"1873","Park","Alternative",35,40,1400,1080,320
"1874","Park","Alternative",32,71,2272,1297,975
"1875","Park","Alternative",35,54,1890,1178,712
"1876","Park","Alternative",32,78,2496,1346,1150
"1877","Park","Alternative",35,55,1925,1185,740
"1878","Park","Alternative",40,38,1520,1066,454
"1879","Park","Alternative",40,28,1120,996,124
"1880","Park","Alternative",40,38,1520,1066,454
"1881","Park","Alternative",40,36,1440,1052,388
"1882","Park","Alternative",40,34,1360,1038,322
"1883","Park","Alternative",32,78,2496,1346,1150
"1884","Park","Alternative",32,77,2464,1339,1125
"1885","Park","Alternative",35,50,1750,1150,600
"1886","Park","Alternative",35,51,1785,1157,628
"1887","Park","Alternative",32,73,2336,1311,1025
"1888","Park","Alternative",32,76,2432,1332,1100
"1889","Park","Alternative",32,66,2112,1262,850
"1890","Park","Alternative",40,28,1120,996,124
"1891","Park","Alternative",40,24,960,968,-8
"1892","Park","Alternative",35,39,1365,1073,292
"1893","Park","Alternative",35,46,1610,1122,488
"1894","Park","Alternative",35,56,1960,1192,768
"1895","Park","Alternative",40,37,1480,1059,421
"1896","Park","Alternative",32,64,2048,1248,800
"1897","Park","Alternative",40,24,960,968,-8
"1898","Park","Alternative",35,38,1330,1066,264
"1899","Park","Alternative",35,48,1680,1136,544
"1900","Park","Alternative",40,30,1200,1010,190
"1901","Park","Alternative",32,66,2112,1262,850
"1902","Park","Alternative",35,61,2135,1227,908
"1903","Park","Alternative",40,34,1360,1038,322
"1904","Park","Alternative",40,22,880,954,-74
"1905","Park","Alternative",40,24,960,968,-8
"1906","Park","Alternative",32,74,2368,1318,1050
"1907","Park","Alternative",35,48,1680,1136,544
"1908","Park","Alternative",40,31,1240,1017,223
"1909","Park","Alternative",32,68,2176,1276,900
"1910","Park","Alternative",32,72,2304,1304,1000
"1911","Park","Alternative",40,32,1280,1024,256
"1912","Park","Alternative",35,44,1540,1108,432
"1913","Park","Alternative",40,39,1560,1073,487
"1914","Park","Alternative",32,74,2368,1318,1050
"1915","Park","Alternative",35,46,1610,1122,488
"1916","Park","Alternative",32,74,2368,1318,1050
"1917","Park","Alternative",32,66,2112,1262,850
"1918","Park","Alternative",32,78,2496,1346,1150
"1919","Park","Alternative",32,70,2240,1290,950
"1920","Park","Alternative",35,43,1505,1101,404
"1921","Park","Alternative",35,46,1610,1122,488
"1922","Park","Alternative",40,36,1440,1052,388
"1923","Park","Alternative",40,31,1240,1017,223
"1924","Park","Alternative",32,68,2176,1276,900
"1925","Park","Alternative",35,47,1645,1129,516
"1926","Park","Alternative",35,44,1540,1108,432
"1927","Park","Alternative",40,44,1760,1108,652
"1928","Park","Alternative",40,38,1520,1066,454
"1929","Park","Alternative",32,75,2400,1325,1075
"1930","Park","Alternative",35,44,1540,1108,432
"1931","Park","Alternative",35,48,1680,1136,544
"1932","Park","Alternative",40,36,1440,1052,388
"1933","Park","Alternative",32,73,2336,1311,1025
"1934","Park","Alternative",32,64,2048,1248,800
"1935","Park","Alternative",32,68,2176,1276,900
"1936","Park","Alternative",35,42,1470,1094,376
"1937","Park","Alternative",40,36,1440,1052,388
"1938","Park","Alternative",40,45,1800,1115,685
"1939","Park","Alternative",35,46,1610,1122,488
"1940","Park","Alternative",35,50,1750,1150,600
"1941","Park","Alternative",40,33,1320,1031,289
"1942","Park","Alternative",40,24,960,968,-8
"1943","Park","Alternative",35,42,1470,1094,376
"1944","Park","Alternative",32,73,2336,1311,1025
"1945","Park","Alternative",32,74,2368,1318,1050
"1946","Park","Alternative",32,74,2368,1318,1050
"1947","Park","Alternative",35,45,1575,1115,460
"1948","Park","Alternative",32,70,2240,1290,950
"1949","Park","Alternative",35,46,1610,1122,488
"1950","Park","Alternative",32,73,2336,1311,1025
"1951","Park","Alternative",32,74,2368,1318,1050
"1952","Park","Alternative",40,32,1280,1024,256
"1953","Park","Alternative",35,54,1890,1178,712
"1954","Park","Alternative",32,76,2432,1332,1100
"1955","Park","Alternative",40,34,1360,1038,322
"1956","Park","Alternative",35,54,1890,1178,712
"1957","Park","Alternative",40,30,1200,1010,190
"1958","Park","Alternative",40,42,1680,1094,586
"1959","Park","Alternative",35,47,1645,1129,516
"1960","Park","Alternative",40,38,1520,1066,454
"1961","Park","Alternative",35,63,2205,1241,964
"1962","Park","Alternative",40,18,720,926,-206
"1963","Park","Alternative",40,36,1440,1052,388
"1964","Park","Alternative",32,62,1984,1234,750
"1965","Park","Alternative",35,50,1750,1150,600
"1966","Park","Alternative",35,54,1890,1178,712
"1967","Park","Alternative",32,63,2016,1241,775
"1968","Park","Alternative",40,25,1000,975,25
"1969","Park","Alternative",35,46,1610,1122,488
"1970","Park","Alternative",35,44,1540,1108,432
"1971","Park","Alternative",32,58,1856,1206,650
"1972","Park","Alternative",32,64,2048,1248,800
"1973","Park","Alternative",32,66,2112,1262,850
"1974","Park","Alternative",32,60,1920,1220,700
"1975","Park","Alternative",32,63,2016,1241,775
"1976","Park","Alternative",40,32,1280,1024,256
"1977","Park","Alternative",40,25,1000,975,25
"1978","Park","Alternative",40,32,1280,1024,256
"1979","Park","Alternative",32,67,2144,1269,875
"1980","Park","Alternative",32,62,1984,1234,750
"1981","Park","Alternative",40,34,1360,1038,322
"1982","Park","Alternative",35,54,1890,1178,712
"1983","Park","Alternative",35,46,1610,1122,488
"1984","Park","Alternative",35,50,1750,1150,600
"1985","Park","Alternative",40,29,1160,1003,157
"1986","Park","Alternative",35,46,1610,1122,488
"1987","Park","Alternative",40,33,1320,1031,289
"1988","Park","Alternative",35,42,1470,1094,376
"1989","Park","Alternative",40,28,1120,996,124
"1990","Park","Alternative",35,46,1610,1122,488
"1991","Park","Alternative",32,62,1984,1234,750
"1992","Park","Alternative",35,51,1785,1157,628
"1993","Park","Alternative",40,35,1400,1045,355
"1994","Park","Alternative",32,62,1984,1234,750
"1995","Park","Alternative",40,35,1400,1045,355
"1996","Park","Alternative",32,70,2240,1290,950
"1997","Park","Alternative",35,47,1645,1129,516
"1998","Park","Alternative",35,38,1330,1066,264
"1999","Park","Alternative",35,34,1190,1038,152
"2000","Park","Alternative",40,37,1480,1059,421
"2001","Park","Alternative",32,70,2240,1290,950
"2002","Park","Alternative",32,70,2240,1290,950
"2003","Park","Alternative",40,30,1200,1010,190
"2004","Park","Alternative",40,30,1200,1010,190
"2005","Park","Alternative",32,60,1920,1220,700
"2006","Park","Alternative",35,42,1470,1094,376
"2007","Park","Alternative",35,40,1400,1080,320
"2008","Park","Alternative",40,26,1040,982,58
"2009","Park","Alternative",32,64,2048,1248,800
"2010","Park","Alternative",32,62,1984,1234,750
"2011","Park","Alternative",35,38,1330,1066,264
"2012","Park","Alternative",40,18,720,926,-206
"2013","Park","Alternative",35,32,1120,1024,96
"2014","Park","Alternative",40,31,1240,1017,223
"2015","Park","Alternative",32,66,2112,1262,850
"2016","Park","Alternative",40,24,960,968,-8
"2017","Park","Alternative",32,54,1728,1178,550
"2018","Park","Alternative",35,30,1050,1010,40
"2019","Park","Alternative",32,48,1536,1136,400
"2020","Park","Alternative",32,43,1376,1101,275
"2021","Park","Alternative",32,52,1664,1164,500
"2022","Park","Alternative",40,22,880,954,-74
"2023","Park","Alternative",40,14,560,898,-338
"2024","Park","Alternative",40,18,720,926,-206
"2025","Park","Alternative",35,36,1260,1052,208
"2026","Park","Alternative",32,49,1568,1143,425
"2027","Park","Alternative",35,36,1260,1052,208
"2028","Park","Alternative",28,82,2296,1374,922
"2029","Park","Alternative",28,78,2184,1346,838
"2030","Park","Alternative",35,30,1050,1010,40
"2031","Park","Alternative",32,56,1792,1192,600
"2032","Park","Alternative",35,41,1435,1087,348
"2033","Park","Alternative",35,34,1190,1038,152
"2034","Park","Alternative",35,40,1400,1080,320
"2035","Park","Alternative",32,62,1984,1234,750
"2036","Park","Alternative",32,53,1696,1171,525
"2037","Park","Alternative",32,57,1824,1199,625
"2038","Park","Alternative",28,78,2184,1346,838
"2039","Park","Alternative",28,83,2324,1381,943
"2040","Park","Alternative",28,75,2100,1325,775
"2041","Park","Alternative",35,39,1365,1073,292
"2042","Park","Alternative",28,72,2016,1304,712
"2043","Park","Alternative",40,22,880,954,-74
"2044","Park","Alternative",40,15,600,905,-305
"2045","Park","Alternative",32,48,1536,1136,400
"2046","Park","Alternative",40,24,960,968,-8
"2047","Park","Alternative",40,20,800,940,-140
"2048","Park","Alternative",32,54,1728,1178,550
"2049","Park","Alternative",28,78,2184,1346,838
"2050","Park","Alternative",40,25,1000,975,25
"2051","Park","Alternative",35,36,1260,1052,208
"2052","Park","Alternative",28,79,2212,1353,859
"2053","Park","Alternative",28,72,2016,1304,712
"2054","Park","Alternative",32,54,1728,1178,550
"2055","Park","Alternative",28,82,2296,1374,922
"2056","Park","Alternative",40,14,560,898,-338
"2057","Park","Alternative",40,28,1120,996,124
"2058","Park","Alternative",28,83,2324,1381,943
"2059","Park","Alternative",35,38,1330,1066,264
"2060","Park","Alternative",35,34,1190,1038,152
"2061","Park","Alternative",35,34,1190,1038,152
"2062","Park","Alternative",35,40,1400,1080,320
"2063","Park","Alternative",40,27,1080,989,91
"2064","Park","Alternative",35,36,1260,1052,208
"2065","Park","Alternative",32,56,1792,1192,600
"2066","Park","Alternative",40,32,1280,1024,256
"2067","Park","Alternative",28,82,2296,1374,922
"2068","Park","Alternative",32,48,1536,1136,400
"2069","Park","Alternative",32,48,1536,1136,400
"2070","Park","Alternative",28,81,2268,1367,901
"2071","Park","Alternative",28,78,2184,1346,838
"2072","Park","Alternative",32,64,2048,1248,800
"2073","Park","Alternative",40,22,880,954,-74
"2074","Park","Alternative",32,64,2048,1248,800
"2075","Park","Alternative",40,33,1320,1031,289
"2076","Park","Alternative",35,41,1435,1087,348
"2077","Park","Alternative",32,53,1696,1171,525
"2078","Park","Alternative",40,24,960,968,-8
"2079","Park","HipHop",28,75,2100,1325,775
"2080","Park","HipHop",40,13,520,891,-371
"2081","Park","Alternative",28,74,2072,1318,754
"2082","Park","HipHop",28,67,1876,1269,607
"2083","Park","HipHop",28,84,2352,1388,964
"2084","Park","Alternative",28,88,2464,1416,1048
"2085","Park","Alternative",40,22,880,954,-74
"2086","Park","HipHop",28,80,2240,1360,880
"2087","Park","HipHop",40,24,960,968,-8
"2088","Park","Alternative",40,18,720,926,-206
"2089","Park","Alternative",40,27,1080,989,91
"2090","Park","Alternative",28,85,2380,1395,985
"2091","Park","Alternative",40,33,1320,1031,289
"2092","Park","Alternative",28,84,2352,1388,964
"2093","Park","HipHop",28,76,2128,1332,796
"2094","Park","Alternative",28,80,2240,1360,880
"2095","Park","Alternative",40,23,920,961,-41
"2096","Park","Alternative",28,78,2184,1346,838
"2097","Park","HipHop",28,74,2072,1318,754
"2098","Park","HipHop",28,74,2072,1318,754
"2099","Park","HipHop",40,22,880,954,-74
"2100","Park","HipHop",40,20,800,940,-140
"2101","Park","HipHop",40,16,640,912,-272
"2102","Park","HipHop",28,77,2156,1339,817
"2103","Park","Alternative",28,82,2296,1374,922
"2104","Park","HipHop",40,17,680,919,-239
"2105","Park","HipHop",28,86,2408,1402,1006
"2106","Park","Alternative",40,22,880,954,-74
"2107","Park","HipHop",40,24,960,968,-8
"2108","Park","Alternative",28,77,2156,1339,817
"2109","Park","Alternative",28,82,2296,1374,922
"2110","Park","Alternative",40,18,720,926,-206
"2111","Park","HipHop",40,14,560,898,-338
"2112","Park","Alternative",40,17,680,919,-239
"2113","Park","HipHop",40,9,360,863,-503
"2114","Park","HipHop",28,76,2128,1332,796
"2115","Park","Alternative",28,80,2240,1360,880
"2116","Park","Alternative",40,23,920,961,-41
"2117","Park","HipHop",40,26,1040,982,58
"2118","Zoo","HipHop",32,37,1184,1059,125
"2119","Zoo","Alternative",32,24,768,968,-200
"2120","CityHall","HipHop",28,46,1288,1122,166
"2121","CityHall","HipHop",40,16,640,912,-272
"2122","CityHall","Alternative",40,16,640,912,-272
"2123","Business","HipHop",40,16,640,912,-272
"2124","CityHall","HipHop",32,28,896,996,-100
"2125","Zoo","HipHop",35,8,280,856,-576
"2126","Park","HipHop",35,32,1120,1024,96
"2127","CityHall","Alternative",32,35,1120,1045,75
"2128","Park","Alternative",35,26,910,982,-72
"2129","Business","Alternative",35,28,980,996,-16
"2130","Park","Alternative",35,24,840,968,-128
"2131","Business","HipHop",35,32,1120,1024,96
"2132","CityHall","Alternative",35,18,630,926,-296
"2133","Park","HipHop",28,68,1904,1276,628
"2134","Zoo","HipHop",28,48,1344,1136,208
"2135","Park","Alternative",35,37,1295,1059,236
"2136","Park","HipHop",35,24,840,968,-128
"2137","CityHall","Alternative",35,12,420,884,-464
"2138","Zoo","HipHop",28,25,700,975,-275
"2139","Business","Alternative",32,31,992,1017,-25
"2140","Business","HipHop",32,42,1344,1094,250
"2141","Business","Alternative",28,48,1344,1136,208
"2142","Business","Alternative",35,0,0,800,-800
"2143","Zoo","Alternative",40,0,0,800,-800
"2144","Zoo","HipHop",32,40,1280,1080,200
"2145","Park","HipHop",35,34,1190,1038,152
"2146","Zoo","Alternative",35,6,210,842,-632
"2147","Park","Alternative",28,70,1960,1290,670
"2148","CityHall","HipHop",28,70,1960,1290,670
"2149","CityHall","Alternative",35,26,910,982,-72
"2150","Zoo","Alternative",35,22,770,954,-184
"2151","Business","HipHop",35,22,770,954,-184
"2152","Park","HipHop",32,48,1536,1136,400
"2153","Business","HipHop",32,44,1408,1108,300
"2154","Zoo","Alternative",40,15,600,905,-305
"2155","CityHall","HipHop",35,18,630,926,-296
"2156","Park","HipHop",32,45,1440,1115,325
"2157","Park","Alternative",32,58,1856,1206,650
"2158","Zoo","HipHop",32,24,768,968,-200
"2159","Business","Alternative",28,58,1624,1206,418
"2160","Zoo","Alternative",28,52,1456,1164,292
"2161","Business","Alternative",40,23,920,961,-41
"2162","Park","Alternative",28,66,1848,1262,586
"2163","CityHall","HipHop",40,24,960,968,-8
"2164","Zoo","Alternative",32,35,1120,1045,75
"2165","CityHall","HipHop",40,10,400,870,-470
"2166","CityHall","Alternative",32,29,928,1003,-75
"2167","CityHall","Alternative",35,40,1400,1080,320
"2168","Park","Alternative",40,34,1360,1038,322
"2169","Business","HipHop",28,20,560,940,-380
"2170","Park","Alternative",40,24,960,968,-8
"2171","Park","Alternative",40,26,1040,982,58
"2172","CityHall","Alternative",28,48,1344,1136,208
"2173","Zoo","Alternative",28,46,1288,1122,166
"2174","Park","Alternative",32,41,1312,1087,225
"2175","Business","Alternative",32,36,1152,1052,100
"2176","Business","HipHop",28,56,1568,1192,376
"2177","Park","HipHop",40,22,880,954,-74
"2178","Park","HipHop",28,59,1652,1213,439
"2179","CityHall","HipHop",35,30,1050,1010,40
"2180","Business","HipHop",40,10,400,870,-470
"2181","Park","HipHop",40,20,800,940,-140
"2182","Zoo","HipHop",35,20,700,940,-240
"2183","Zoo","Alternative",35,32,1120,1024,96
"2184","Business","Alternative",40,0,0,800,-800
"2185","Business","Alternative",35,16,560,912,-352
"2186","Business","HipHop",32,42,1344,1094,250
"2187","Zoo","HipHop",35,19,665,933,-268
"2188","Zoo","Alternative",28,61,1708,1227,481
"2189","Business","HipHop",32,16,512,912,-400
"2190","CityHall","HipHop",28,54,1512,1178,334
"2191","Zoo","HipHop",40,19,760,933,-173
"2192","Zoo","HipHop",40,14,560,898,-338
"2193","Park","Alternative",32,32,1024,1024,0
"2194","CityHall","HipHop",32,45,1440,1115,325
"2195","Zoo","HipHop",40,5,200,835,-635
"2196","CityHall","HipHop",32,45,1440,1115,325
"2197","Zoo","HipHop",32,0,0,800,-800
"2198","CityHall","HipHop",35,12,420,884,-464
"2199","Business","Alternative",28,63,1764,1241,523
"2200","Business","Alternative",28,18,504,926,-422
"2201","CityHall","Alternative",40,14,560,898,-338
"2202","Park","HipHop",40,13,520,891,-371
"2203","Park","HipHop",28,77,2156,1339,817
"2204","Business","HipHop",40,16,640,912,-272
"2205","Park","Alternative",28,78,2184,1346,838
"2206","CityHall","HipHop",40,0,0,800,-800
"2207","Zoo","Alternative",28,26,728,982,-254
"2208","Zoo","Alternative",32,38,1216,1066,150
"2209","Park","HipHop",28,58,1624,1206,418
"2210","Business","Alternative",40,18,720,926,-206
"2211","CityHall","Alternative",40,11,440,877,-437
"2212","Business","HipHop",40,3,120,821,-701
"2213","CityHall","HipHop",28,30,840,1010,-170
"2214","Park","HipHop",32,52,1664,1164,500
"2215","Business","Alternative",40,14,560,898,-338
"2216","Business","Alternative",35,26,910,982,-72
"2217","Zoo","HipHop",35,24,840,968,-128
"2218","CityHall","HipHop",35,30,1050,1010,40
"2219","Business","Alternative",32,40,1280,1080,200
"2220","Business","HipHop",28,52,1456,1164,292
"2221","CityHall","Alternative",40,6,240,842,-602
"2222","Zoo","Alternative",40,18,720,926,-206
"2223","Park","HipHop",35,34,1190,1038,152
"2224","Zoo","Alternative",32,15,480,905,-425
"2225","Business","HipHop",35,4,140,828,-688
"2226","Park","Alternative",28,58,1624,1206,418
"2227","Zoo","HipHop",28,60,1680,1220,460
"2228","Zoo","HipHop",28,37,1036,1059,-23
"2229","Business","HipHop",28,62,1736,1234,502
"2230","CityHall","HipHop",32,22,704,954,-250
"2231","Zoo","Alternative",35,23,805,961,-156
"2232","Business","HipHop",35,40,1400,1080,320
"2233","CityHall","Alternative",28,46,1288,1122,166
"2234","Park","Alternative",32,38,1216,1066,150
"2235","Zoo","HipHop",40,24,960,968,-8
"2236","Park","HipHop",40,8,320,856,-536
"2237","Park","Alternative",40,29,1160,1003,157
"2238","CityHall","Alternative",32,50,1600,1150,450
"2239","CityHall","Alternative",28,32,896,1024,-128
"2240","Park","Alternative",35,34,1190,1038,152
"2241","Zoo","Alternative",40,6,240,842,-602
"2242","Park","HipHop",32,32,1024,1024,0
"2243","CityHall","Alternative",32,27,864,989,-125
"2244","CityHall","Alternative",28,66,1848,1262,586
"2245","Business","Alternative",32,12,384,884,-500
"2246","Business","HipHop",35,26,910,982,-72
"2247","Zoo","Alternative",35,24,840,968,-128
"2248","CityHall","Alternative",32,22,704,954,-250
"2249","Business","HipHop",32,36,1152,1052,100
"2250","Business","Alternative",40,12,480,884,-404
"2251","Business","Alternative",40,16,640,912,-272
"2252","Business","HipHop",28,30,840,1010,-170
"2253","Zoo","Alternative",40,0,0,800,-800
"2254","CityHall","Alternative",32,35,1120,1045,75
"2255","CityHall","HipHop",28,24,672,968,-296
"2256","Business","HipHop",40,13,520,891,-371
"2257","Zoo","HipHop",32,28,896,996,-100
"2258","Park","HipHop",35,22,770,954,-184
"2259","CityHall","Alternative",40,14,560,898,-338
"2260","CityHall","HipHop",35,27,945,989,-44
"2261","Park","HipHop",28,56,1568,1192,376
"2262","Zoo","Alternative",40,14,560,898,-338
"2263","Business","HipHop",40,0,0,800,-800
"2264","CityHall","Alternative",35,20,700,940,-240
"2265","Zoo","Alternative",40,10,400,870,-470
"2266","CityHall","Alternative",40,4,160,828,-668
"2267","Business","Alternative",32,28,896,996,-100
"2268","Business","HipHop",28,50,1400,1150,250
"2269","Business","Alternative",40,11,440,877,-437
"2270","Park","HipHop",32,41,1312,1087,225
"2271","Zoo","HipHop",28,10,280,870,-590
"2272","CityHall","HipHop",32,40,1280,1080,200
"2273","CityHall","HipHop",40,11,440,877,-437
"2274","CityHall","HipHop",35,18,630,926,-296
"2275","CityHall","Alternative",28,38,1064,1066,-2
"2276","Zoo","HipHop",35,20,700,940,-240
"2277","Park","HipHop",40,20,800,940,-140
"2278","Park","HipHop",32,52,1664,1164,500
"2279","Zoo","HipHop",28,61,1708,1227,481
"2280","Park","Alternative",28,62,1736,1234,502
"2281","Business","HipHop",28,60,1680,1220,460
"2282","Park","HipHop",32,38,1216,1066,150
"2283","CityHall","Alternative",32,46,1472,1122,350
"2284","CityHall","HipHop",28,78,2184,1346,838
"2285","Park","Alternative",32,48,1536,1136,400
"2286","CityHall","Alternative",28,36,1008,1052,-44
"2287","CityHall","Alternative",35,30,1050,1010,40
"2288","Zoo","HipHop",35,20,700,940,-240
"2289","Business","HipHop",35,0,0,800,-800
"2290","Business","Alternative",32,17,544,919,-375
"2291","Park","Alternative",28,66,1848,1262,586
"2292","CityHall","Alternative",40,16,640,912,-272
"2293","Zoo","HipHop",40,0,0,800,-800
"2294","Business","Alternative",35,20,700,940,-240
"2295","Zoo","Alternative",35,22,770,954,-184
"2296","CityHall","HipHop",40,20,800,940,-140
"2297","Park","Alternative",40,18,720,926,-206
"2298","Park","HipHop",40,18,720,926,-206
"2299","Business","Alternative",28,10,280,870,-590
"2300","Business","HipHop",28,56,1568,1192,376
"2301","Business","Alternative",28,45,1260,1115,145
"2302","CityHall","Alternative",32,28,896,996,-100
"2303","Park","Alternative",35,32,1120,1024,96
"2304","Park","HipHop",40,12,480,884,-404
"2305","Park","Alternative",32,32,1024,1024,0
"2306","Zoo","Alternative",28,54,1512,1178,334
"2307","Zoo","HipHop",35,18,630,926,-296
"2308","Business","Alternative",28,46,1288,1122,166
"2309","Business","Alternative",35,0,0,800,-800
"2310","Business","Alternative",28,46,1288,1122,166
"2311","Park","Alternative",40,12,480,884,-404
"2312","Park","Alternative",40,18,720,926,-206
"2313","Zoo","HipHop",32,33,1056,1031,25
"2314","Business","HipHop",35,30,1050,1010,40
"2315","Zoo","Alternative",35,29,1015,1003,12
"2316","CityHall","HipHop",32,22,704,954,-250
"2317","Zoo","Alternative",28,41,1148,1087,61
"2318","Business","HipHop",32,38,1216,1066,150
"2319","Business","Alternative",40,1,40,807,-767
"2320","Zoo","Alternative",40,20,800,940,-140
"2321","Zoo","HipHop",32,18,576,926,-350
"2322","CityHall","HipHop",35,32,1120,1024,96
"2323","Business","HipHop",40,16,640,912,-272
"2324","CityHall","HipHop",32,23,736,961,-225
"2325","Business","Alternative",32,28,896,996,-100
"2326","Park","Alternative",35,29,1015,1003,12
"2327","Park","HipHop",40,18,720,926,-206
"2328","Business","Alternative",35,24,840,968,-128
"2329","Park","HipHop",35,26,910,982,-72
"2330","CityHall","Alternative",28,75,2100,1325,775
"2331","CityHall","HipHop",28,47,1316,1129,187
"2332","CityHall","Alternative",35,15,525,905,-380
"2333","Business","HipHop",35,22,770,954,-184
"2334","CityHall","HipHop",40,13,520,891,-371
"2335","Zoo","HipHop",40,11,440,877,-437
"2336","Zoo","HipHop",32,39,1248,1073,175
"2337","CityHall","Alternative",35,20,700,940,-240
"2338","Business","Alternative",35,24,840,968,-128
"2339","Business","Alternative",32,31,992,1017,-25
"2340","CityHall","Alternative",28,56,1568,1192,376
"2341","Park","HipHop",35,30,1050,1010,40
"2342","Zoo","HipHop",40,6,240,842,-602
"2343","Zoo","HipHop",35,14,490,898,-408
"2344","Zoo","Alternative",32,44,1408,1108,300
"2345","Park","Alternative",35,22,770,954,-184
"2346","Zoo","Alternative",28,51,1428,1157,271
"2347","Park","HipHop",35,40,1400,1080,320
"2348","Park","Alternative",28,67,1876,1269,607
"2349","CityHall","HipHop",35,14,490,898,-408
"2350","Park","Alternative",32,36,1152,1052,100
"2351","CityHall","HipHop",28,30,840,1010,-170
"2352","Zoo","Alternative",32,24,768,968,-200
"2353","Zoo","Alternative",32,25,800,975,-175
"2354","Park","HipHop",28,54,1512,1178,334
"2355","Zoo","Alternative",32,40,1280,1080,200
"2356","Park","HipHop",28,84,2352,1388,964
"2357","Park","HipHop",32,54,1728,1178,550
"2358","CityHall","HipHop",32,48,1536,1136,400
"2359","Park","Alternative",40,28,1120,996,124
"2360","CityHall","HipHop",40,13,520,891,-371
"2361","Zoo","HipHop",28,34,952,1038,-86
"2362","Zoo","Alternative",28,14,392,898,-506
"2363","CityHall","Alternative",40,6,240,842,-602
"2364","Zoo","Alternative",35,12,420,884,-464
"2365","Park","Alternative",28,78,2184,1346,838
"2366","Park","Alternative",35,32,1120,1024,96
"2367","Zoo","HipHop",28,56,1568,1192,376
"2368","Business","HipHop",32,11,352,877,-525
"2369","Business","HipHop",32,36,1152,1052,100
"2370","Zoo","HipHop",40,15,600,905,-305
"2371","Park","Alternative",32,58,1856,1206,650
"2372","Park","HipHop",28,58,1624,1206,418
"2373","Business","HipHop",40,16,640,912,-272
"2374","Park","HipHop",40,13,520,891,-371
"2375","Park","HipHop",28,62,1736,1234,502
"2376","Zoo","HipHop",32,36,1152,1052,100
"2377","CityHall","Alternative",35,18,630,926,-296
"2378","Park","Alternative",32,36,1152,1052,100
"2379","Zoo","Alternative",32,18,576,926,-350
"2380","Zoo","HipHop",35,12,420,884,-464
"2381","Business","HipHop",28,24,672,968,-296
"2382","Business","HipHop",35,22,770,954,-184
"2383","Zoo","Alternative",35,24,840,968,-128
"2384","CityHall","HipHop",40,18,720,926,-206
"2385","Park","HipHop",40,24,960,968,-8
"2386","Park","HipHop",32,45,1440,1115,325
"2387","Business","HipHop",28,60,1680,1220,460
"2388","Park","Alternative",28,58,1624,1206,418
"2389","CityHall","HipHop",32,15,480,905,-425
"2390","Park","HipHop",35,28,980,996,-16
"2391","Business","HipHop",32,12,384,884,-500
"2392","Business","Alternative",35,14,490,898,-408
"2393","Zoo","Alternative",35,12,420,884,-464
"2394","CityHall","HipHop",35,29,1015,1003,12
"2395","Park","Alternative",40,28,1120,996,124
"2396","Park","HipHop",40,18,720,926,-206
"2397","Zoo","HipHop",40,2,80,814,-734
"2398","CityHall","Alternative",28,38,1064,1066,-2
"2399","Zoo","HipHop",32,40,1280,1080,200
"2400","CityHall","Alternative",28,57,1596,1199,397
"2401","Zoo","Alternative",40,9,360,863,-503
"2402","Business","HipHop",40,0,0,800,-800
"2403","Park","HipHop",35,18,630,926,-296
"2404","Zoo","Alternative",32,39,1248,1073,175
"2405","Business","HipHop",35,22,770,954,-184
"2406","Zoo","Alternative",28,50,1400,1150,250
"2407","Park","HipHop",28,56,1568,1192,376
"2408","CityHall","HipHop",40,19,760,933,-173
"2409","Business","Alternative",28,50,1400,1150,250
"2410","Business","Alternative",40,18,720,926,-206
"2411","Park","HipHop",32,37,1184,1059,125
"2412","CityHall","HipHop",35,24,840,968,-128
"2413","Business","Alternative",32,14,448,898,-450
"2414","CityHall","HipHop",28,41,1148,1087,61
"2415","Business","Alternative",32,40,1280,1080,200
"2416","CityHall","Alternative",35,20,700,940,-240
"2417","Zoo","HipHop",40,16,640,912,-272
"2418","Park","Alternative",35,34,1190,1038,152
"2419","Zoo","HipHop",28,6,168,842,-674
"2420","CityHall","Alternative",32,34,1088,1038,50
"2421","Business","HipHop",35,3,105,821,-716
"2422","Park","Alternative",35,24,840,968,-128
"2423","CityHall","Alternative",35,30,1050,1010,40
"2424","Park","Alternative",35,24,840,968,-128
"2425","Business","Alternative",28,49,1372,1143,229
"2426","Business","Alternative",40,10,400,870,-470
"2427","CityHall","Alternative",32,32,1024,1024,0
"2428","Business","Alternative",28,18,504,926,-422
"2429","Park","Alternative",28,55,1540,1185,355
"2430","CityHall","Alternative",40,16,640,912,-272
"2431","CityHall","Alternative",35,20,700,940,-240
"2432","CityHall","Alternative",40,4,160,828,-668
"2433","CityHall","HipHop",28,56,1568,1192,376
"2434","CityHall","HipHop",40,10,400,870,-470
"2435","Business","HipHop",32,30,960,1010,-50
"2436","Park","HipHop",40,25,1000,975,25
"2437","Zoo","HipHop",35,10,350,870,-520
"2438","Business","Alternative",40,2,80,814,-734
"2439","Park","HipHop",32,36,1152,1052,100
"2440","Zoo","Alternative",35,6,210,842,-632
"2441","Zoo","HipHop",40,12,480,884,-404
"2442","CityHall","HipHop",32,28,896,996,-100
"2443","Park","Alternative",32,46,1472,1122,350
"2444","Business","Alternative",40,24,960,968,-8
"2445","CityHall","Alternative",28,42,1176,1094,82
"2446","Business","Alternative",35,21,735,947,-212
"2447","Park","HipHop",35,40,1400,1080,320
"2448","CityHall","HipHop",40,13,520,891,-371
"2449","Zoo","HipHop",28,52,1456,1164,292
"2450","Zoo","Alternative",32,40,1280,1080,200
"2451","Zoo","Alternative",40,19,760,933,-173
"2452","Park","Alternative",40,20,800,940,-140
"2453","Zoo","HipHop",35,6,210,842,-632
"2454","Park","HipHop",35,23,805,961,-156
"2455","CityHall","Alternative",32,48,1536,1136,400
"2456","Business","Alternative",28,55,1540,1185,355
"2457","Zoo","HipHop",40,0,0,800,-800
"2458","Zoo","HipHop",32,17,544,919,-375
"2459","Park","Alternative",28,58,1624,1206,418
"2460","Zoo","HipHop",28,38,1064,1066,-2
"2461","Zoo","Alternative",35,21,735,947,-212
"2462","Park","Alternative",40,19,760,933,-173
"2463","Zoo","HipHop",28,58,1624,1206,418
"2464","Business","HipHop",40,12,480,884,-404
"2465","Business","Alternative",35,8,280,856,-576
"2466","Business","HipHop",35,26,910,982,-72
"2467","Zoo","HipHop",35,26,910,982,-72
"2468","Business","HipHop",28,54,1512,1178,334
"2469","CityHall","HipHop",35,27,945,989,-44
"2470","Park","Alternative",32,42,1344,1094,250
"2471","Business","HipHop",32,38,1216,1066,150
"2472","Zoo","Alternative",40,16,640,912,-272
"2473","Park","Alternative",32,62,1984,1234,750
"2474","CityHall","HipHop",32,33,1056,1031,25
"2475","Business","Alternative",35,13,455,891,-436
"2476","Park","Alternative",40,18,720,926,-206
"2477","CityHall","HipHop",28,44,1232,1108,124
"2478","Business","HipHop",40,12,480,884,-404
"2479","Zoo","Alternative",28,55,1540,1185,355
"2480","Business","Alternative",32,27,864,989,-125
"2481","Park","HipHop",28,61,1708,1227,481
"2482","Business","Alternative",32,39,1248,1073,175
"2483","CityHall","HipHop",32,44,1408,1108,300
"2484","Park","Alternative",35,36,1260,1052,208
"2485","Zoo","Alternative",32,23,736,961,-225
"2486","CityHall","Alternative",40,19,760,933,-173
"2487","Park","HipHop",32,38,1216,1066,150
"2488","Park","HipHop",28,74,2072,1318,754
"2489","CityHall","HipHop",28,69,1932,1283,649
"2490","Park","Alternative",28,78,2184,1346,838
"2491","Zoo","HipHop",32,13,416,891,-475
"2492","Business","HipHop",40,16,640,912,-272
"2493","CityHall","HipHop",35,22,770,954,-184
"2494","Zoo","Alternative",40,0,0,800,-800
"2495","Zoo","Alternative",28,54,1512,1178,334
"2496","CityHall","Alternative",32,20,640,940,-300
"2497","Business","HipHop",28,53,1484,1171,313
"2498","Business","HipHop",32,36,1152,1052,100
"2499","Zoo","Alternative",28,26,728,982,-254
"2500","CityHall","Alternative",28,72,2016,1304,712
"2501","CityHall","Alternative",40,8,320,856,-536
"2502","Park","HipHop",28,58,1624,1206,418
"2503","Business","HipHop",40,12,480,884,-404
"2504","Business","Alternative",35,4,140,828,-688
"2505","CityHall","Alternative",32,42,1344,1094,250
"2506","Business","HipHop",40,6,240,842,-602
"2507","CityHall","Alternative",35,18,630,926,-296
"2508","Business","HipHop",28,44,1232,1108,124
"2509","CityHall","HipHop",40,14,560,898,-338
"2510","Zoo","HipHop",40,2,80,814,-734
"2511","CityHall","HipHop",40,20,800,940,-140
"2512","Park","HipHop",32,56,1792,1192,600
"2513","Zoo","HipHop",28,20,560,940,-380
"2514","CityHall","Alternative",32,28,896,996,-100
"2515","Zoo","Alternative",35,18,630,926,-296
"2516","Park","Alternative",32,48,1536,1136,400
"2517","Business","Alternative",28,18,504,926,-422
"2518","Park","Alternative",35,39,1365,1073,292
"2519","Business","HipHop",28,56,1568,1192,376
"2520","CityHall","HipHop",28,55,1540,1185,355
"2521","Park","HipHop",32,50,1600,1150,450
"2522","Business","Alternative",28,51,1428,1157,271
"2523","Park","Alternative",35,38,1330,1066,264
"2524","CityHall","HipHop",32,43,1376,1101,275
"2525","Business","Alternative",35,23,805,961,-156
"2526","CityHall","HipHop",40,10,400,870,-470
"2527","Business","Alternative",28,50,1400,1150,250
"2528","Zoo","Alternative",35,16,560,912,-352
"2529","Zoo","Alternative",32,28,896,996,-100
"2530","CityHall","HipHop",40,4,160,828,-668
"2531","Business","Alternative",32,26,832,982,-150
"2532","CityHall","Alternative",40,16,640,912,-272
"2533","Business","HipHop",32,37,1184,1059,125
"2534","Park","Alternative",40,18,720,926,-206
"2535","Park","HipHop",40,17,680,919,-239
"2536","Business","HipHop",35,2,70,814,-744
"2537","Zoo","HipHop",32,16,512,912,-400
"2538","Business","Alternative",28,54,1512,1178,334
"2539","Park","Alternative",40,20,800,940,-140
"2540","Business","Alternative",32,31,992,1017,-25
"2541","Zoo","Alternative",40,20,800,940,-140
"2542","Park","HipHop",35,24,840,968,-128
"2543","CityHall","Alternative",28,70,1960,1290,670
"2544","CityHall","Alternative",28,43,1204,1101,103
"2545","Business","HipHop",32,44,1408,1108,300
"2546","Zoo","Alternative",32,40,1280,1080,200
"2547","Business","HipHop",28,18,504,926,-422
"2548","Zoo","Alternative",28,62,1736,1234,502
"2549","Park","HipHop",40,10,400,870,-470
"2550","Zoo","Alternative",28,59,1652,1213,439
"2551","Park","Alternative",32,48,1536,1136,400
"2552","Park","Alternative",32,45,1440,1115,325
"2553","Park","HipHop",32,45,1440,1115,325
"2554","Park","HipHop",40,16,640,912,-272
"2555","Zoo","HipHop",35,24,840,968,-128
"2556","Zoo","Alternative",32,18,576,926,-350
"2557","Zoo","HipHop",28,53,1484,1171,313
"2558","Park","Alternative",28,62,1736,1234,502
"2559","CityHall","HipHop",32,24,768,968,-200
"2560","Park","HipHop",35,24,840,968,-128
"2561","CityHall","HipHop",32,37,1184,1059,125
"2562","Zoo","HipHop",32,45,1440,1115,325
"2563","Park","Alternative",32,50,1600,1150,450
"2564","Business","HipHop",35,28,980,996,-16
"2565","Business","Alternative",40,12,480,884,-404
"2566","Zoo","Alternative",28,26,728,982,-254
"2567","CityHall","HipHop",35,26,910,982,-72
"2568","Business","Alternative",32,35,1120,1045,75
"2569","Zoo","HipHop",40,12,480,884,-404
"2570","CityHall","Alternative",40,14,560,898,-338
"2571","Zoo","Alternative",35,23,805,961,-156
"2572","Zoo","HipHop",28,52,1456,1164,292
"2573","Zoo","HipHop",32,31,992,1017,-25
"2574","Zoo","HipHop",28,46,1288,1122,166
"2575","Zoo","HipHop",35,9,315,863,-548
"2576","Zoo","HipHop",40,10,400,870,-470
"2577","CityHall","HipHop",32,22,704,954,-250
"2578","Business","HipHop",32,13,416,891,-475
"2579","Park","HipHop",40,10,400,870,-470
"2580","CityHall","HipHop",35,26,910,982,-72
"2581","Zoo","Alternative",35,10,350,870,-520
"2582","Business","Alternative",40,20,800,940,-140
"2583","Business","HipHop",35,23,805,961,-156
"2584","Zoo","Alternative",40,20,800,940,-140
"2585","Business","HipHop",28,48,1344,1136,208
"2586","CityHall","Alternative",35,32,1120,1024,96
"2587","Park","HipHop",28,75,2100,1325,775
"2588","Park","Alternative",35,29,1015,1003,12
"2589","Zoo","HipHop",40,12,480,884,-404
"2590","Business","Alternative",32,22,704,954,-250
"2591","Zoo","HipHop",32,32,1024,1024,0
"2592","Park","HipHop",28,66,1848,1262,586
"2593","Park","Alternative",40,27,1080,989,91
"2594","Zoo","HipHop",35,20,700,940,-240
"2595","Park","HipHop",35,14,490,898,-408
"2596","Zoo","Alternative",40,12,480,884,-404
"2597","CityHall","HipHop",28,67,1876,1269,607
"2598","Business","HipHop",35,17,595,919,-324
"2599","CityHall","Alternative",28,28,784,996,-212
"2600","Park","Alternative",40,12,480,884,-404
"2601","Park","HipHop",35,32,1120,1024,96
"2602","Zoo","HipHop",35,20,700,940,-240
"2603","Zoo","Alternative",40,10,400,870,-470
"2604","Park","Alternative",28,86,2408,1402,1006
"2605","CityHall","HipHop",28,29,812,1003,-191
"2606","CityHall","HipHop",28,49,1372,1143,229
"2607","Business","HipHop",40,15,600,905,-305
"2608","CityHall","Alternative",40,4,160,828,-668
"2609","Business","Alternative",40,12,480,884,-404
"2610","Business","Alternative",40,0,0,800,-800
"2611","CityHall","Alternative",32,52,1664,1164,500
"2612","CityHall","Alternative",32,6,192,842,-650
"2613","Park","HipHop",28,60,1680,1220,460
"2614","CityHall","HipHop",35,22,770,954,-184
"2615","CityHall","Alternative",35,30,1050,1010,40
"2616","Park","HipHop",32,36,1152,1052,100
"2617","Park","Alternative",28,59,1652,1213,439
"2618","Business","HipHop",40,16,640,912,-272
"2619","Business","HipHop",32,22,704,954,-250
"2620","CityHall","Alternative",35,33,1155,1031,124
"2621","Business","Alternative",35,21,735,947,-212
"2622","Park","Alternative",35,25,875,975,-100
"2623","Zoo","Alternative",28,44,1232,1108,124
"2624","Park","Alternative",28,58,1624,1206,418
"2625","CityHall","Alternative",28,60,1680,1220,460
"2626","Park","HipHop",28,52,1456,1164,292
"2627","Zoo","Alternative",32,44,1408,1108,300
"2628","CityHall","Alternative",40,12,480,884,-404
"2629","CityHall","HipHop",35,14,490,898,-408
"2630","Business","Alternative",35,22,770,954,-184
"2631","Park","HipHop",28,62,1736,1234,502
"2632","Zoo","HipHop",28,40,1120,1080,40
"2633","Zoo","HipHop",28,53,1484,1171,313
"2634","Zoo","HipHop",28,52,1456,1164,292
"2635","Park","HipHop",28,66,1848,1262,586
"2636","Park","HipHop",28,56,1568,1192,376
"2637","Park","HipHop",28,48,1344,1136,208
"2638","Business","HipHop",32,36,1152,1052,100
"2639","Business","HipHop",28,42,1176,1094,82
"2640","Park","HipHop",32,32,1024,1024,0
"2641","Park","HipHop",40,20,800,940,-140
"2642","Park","HipHop",40,24,960,968,-8
"2643","Park","HipHop",40,22,880,954,-74
"2644","Park","HipHop",40,18,720,926,-206
"2645","Park","HipHop",40,20,800,940,-140
"2646","Park","HipHop",40,25,1000,975,25
"2647","Park","HipHop",32,44,1408,1108,300
"2648","Park","HipHop",32,39,1248,1073,175
"2649","Park","HipHop",32,42,1344,1094,250
"2650","Park","HipHop",40,20,800,940,-140
"2651","Park","HipHop",40,16,640,912,-272
"2652","Park","HipHop",40,32,1280,1024,256
"2653","Park","HipHop",40,20,800,940,-140
"2654","Park","HipHop",40,24,960,968,-8
"2655","Park","HipHop",40,12,480,884,-404
"2656","Park","HipHop",40,26,1040,982,58
"2657","Park","HipHop",40,18,720,926,-206
"2658","Park","HipHop",40,14,560,898,-338
"2659","Park","HipHop",40,16,640,912,-272
"2660","Park","HipHop",40,24,960,968,-8
"2661","Park","HipHop",40,17,680,919,-239
"2662","Park","HipHop",40,16,640,912,-272
"2663","Park","HipHop",40,10,400,870,-470
"2664","Park","HipHop",40,24,960,968,-8
"2665","Park","HipHop",40,25,1000,975,25
"2666","Park","HipHop",40,24,960,968,-8
"2667","Park","HipHop",40,22,880,954,-74
"2668","Park","HipHop",40,14,560,898,-338
"2669","Park","HipHop",40,17,680,919,-239
"2670","Park","HipHop",40,9,360,863,-503
"2671","Park","HipHop",40,16,640,912,-272
"2672","Park","HipHop",40,27,1080,989,91
"2673","Park","HipHop",40,12,480,884,-404
"2674","Park","HipHop",40,14,560,898,-338
"2675","Park","HipHop",40,11,440,877,-437
"2676","Park","HipHop",40,20,800,940,-140
"2677","Park","HipHop",32,55,1760,1185,575
"2678","Park","HipHop",32,36,1152,1052,100
"2679","Park","HipHop",32,46,1472,1122,350
"2680","Business","HipHop",32,24,768,968,-200
"2681","Business","HipHop",32,9,288,863,-575
"2682","Business","HipHop",32,32,1024,1024,0
"2683","Park","HipHop",32,52,1664,1164,500
"2684","Park","HipHop",32,35,1120,1045,75
"2685","Park","HipHop",32,41,1312,1087,225
"2686","Park","HipHop",32,52,1664,1164,500
"2687","Park","HipHop",32,46,1472,1122,350
"2688","Park","HipHop",32,48,1536,1136,400
"2689","Park","HipHop",32,50,1600,1150,450
"2690","Park","HipHop",32,32,1024,1024,0
"2691","Park","HipHop",32,46,1472,1122,350
"2692","Park","HipHop",32,36,1152,1052,100
"2693","Park","HipHop",32,47,1504,1129,375
"2694","Park","HipHop",32,47,1504,1129,375
"2695","Park","HipHop",32,56,1792,1192,600
"2696","Park","HipHop",32,38,1216,1066,150
"2697","Park","HipHop",32,40,1280,1080,200
"2698","Park","HipHop",32,52,1664,1164,500
"2699","Park","HipHop",32,36,1152,1052,100
"2700","Park","HipHop",32,32,1024,1024,0
"2701","Park","HipHop",32,46,1472,1122,350
"2702","Park","HipHop",32,40,1280,1080,200
"2703","Park","HipHop",32,58,1856,1206,650
"2704","Park","HipHop",32,34,1088,1038,50
"2705","Park","HipHop",32,48,1536,1136,400
"2706","Park","HipHop",32,43,1376,1101,275
"2707","Park","HipHop",32,50,1600,1150,450
"2708","Park","HipHop",32,38,1216,1066,150
"2709","Park","HipHop",32,36,1152,1052,100
"2710","Park","HipHop",32,52,1664,1164,500
"2711","Park","HipHop",32,43,1376,1101,275
"2712","Park","HipHop",32,40,1280,1080,200
"2713","Park","HipHop",32,44,1408,1108,300
"2714","Park","HipHop",32,44,1408,1108,300
"2715","Park","HipHop",32,38,1216,1066,150
"2716","Park","HipHop",32,44,1408,1108,300
"2717","Park","HipHop",32,46,1472,1122,350
"2718","Park","HipHop",32,58,1856,1206,650
"2719","Park","HipHop",28,49,1372,1143,229
"2720","Park","HipHop",32,52,1664,1164,500
"2721","Park","HipHop",28,52,1456,1164,292
"2722","Park","HipHop",32,46,1472,1122,350
"2723","Park","HipHop",28,76,2128,1332,796
"2724","Park","HipHop",32,44,1408,1108,300
